{
    "tilemap": {
        "W": 32,
        "H": 22,
        "tilemap": [
            434, 435, 434, 435, 434, 435, 434, 435, 45, 45, 45, 45, 434, 435, 45, 45, 45, 45, 45, 45, 434, 435, 45, 45, 434, 435, 45, 45, 434, 435, 434, 435, 
            498, 499, 498, 499, 498, 499, 498, 499, 45, 45, 45, 45, 498, 499, 45, 45, 45, 45, 45, 45, 498, 499, 45, 45, 498, 499, 45, 45, 498, 499, 498, 499, 
            434, 435, 434, 435, 434, 435, 434, 435, 45, 45, 45, 45, 434, 435, 45, 45, 45, 45, 45, 45, 434, 435, 45, 45, 434, 435, 45, 45, 434, 435, 434, 435, 
            498, 499, 498, 499, 498, 499, 498, 499, 45, 45, 45, 45, 498, 499, 45, 45, 45, 45, 45, 45, 498, 499, 45, 45, 498, 499, 45, 45, 498, 499, 498, 499, 
            434, 435, 434, 435, 45, 45, 45, 45, 45, 45, 45, 45, 45, 45, 45, 45, 45, 45, 45, 45, 45, 45, 45, 45, 45, 45, 45, 45, 434, 435, 434, 435, 
            498, 499, 498, 499, 45, 45, 45, 45, 45, 45, 45, 45, 45, 45, 45, 45, 45, 45, 45, 45, 45, 45, 45, 45, 45, 45, 45, 45, 498, 499, 498, 499, 
            045, 45, 45, 45, 45, 45, 434, 435, 45, 45, 45, 45, 45, 45, 45, 45, 45, 45, 45, 45, 434, 435, 45, 45, 45, 45, 45, 45, 45, 45, 434, 435, 
            045, 45, 45, 45, 45, 45, 498, 499, 45, 45, 45, 45, 45, 45, 45, 45, 45, 45, 45, 45, 498, 499, 45, 45, 45, 45, 45, 45, 45, 45, 498, 499, 
            045, 45, 45, 45, 45, 45, 45, 45, 45, 45, 45, 45, 434, 435, 45, 45, 45, 45, 45, 45, 45, 45, 45, 45, 45, 45, 45, 45, 45, 45, 45, 45, 
            045, 45, 45, 45, 45, 45, 45, 45, 45, 45, 45, 45, 498, 499, 45, 45, 45, 45, 45, 45, 45, 45, 45, 45, 45, 45, 45, 45, 45, 45, 45, 45, 
            045, 45, 45, 45, 45, 45, 434, 435, 45, 45, 45, 45, 45, 45, 45, 45, 45, 45, 45, 45, 434, 435, 45, 45, 434, 435, 45, 45, 45, 45, 45, 45, 
            045, 45, 45, 45, 45, 45, 498, 499, 45, 45, 45, 45, 45, 45, 45, 45, 45, 45, 45, 45, 498, 499, 45, 45, 498, 499, 45, 45, 45, 45, 45, 45, 
            045, 45, 45, 45, 45, 45, 45, 45, 45, 45, 45, 45, 434, 435, 45, 45, 45, 45, 45, 45, 45, 45, 45, 45, 45, 45, 45, 45, 45, 45, 45, 45, 
            045, 45, 45, 45, 45, 45, 45, 45, 45, 45, 45, 45, 498, 499, 45, 45, 45, 45, 45, 45, 45, 45, 45, 45, 45, 45, 45, 45, 45, 45, 45, 45, 
            045, 45, 45, 45, 45, 45, 434, 435, 45, 45, 45, 45, 45, 45, 45, 45, 45, 45, 45, 45, 434, 435, 45, 45, 45, 45, 45, 45, 45, 45, 434, 435, 
            045, 45, 45, 45, 45, 45, 498, 499, 45, 45, 45, 45, 45, 45, 45, 45, 45, 45, 45, 45, 498, 499, 45, 45, 45, 45, 45, 45, 45, 45, 498, 499, 
            434, 435, 434, 435, 45, 45, 45, 45, 45, 45, 45, 45, 45, 45, 45, 45, 45, 45, 45, 45, 45, 45, 45, 45, 45, 45, 45, 45, 434, 435, 434, 435, 
            498, 499, 498, 499, 45, 45, 45, 45, 45, 45, 45, 45, 45, 45, 45, 45, 45, 45, 45, 45, 45, 45, 45, 45, 45, 45, 45, 45, 498, 499, 498, 499, 
            434, 435, 434, 435, 434, 435, 434, 435, 434, 435, 434, 435, 434, 435, 45, 45, 45, 45, 45, 45, 434, 435, 45, 45, 434, 435, 45, 45, 434, 435, 434, 435, 
            498, 499, 498, 499, 498, 499, 498, 499, 498, 499, 498, 499, 498, 499, 45, 45, 45, 45, 45, 45, 498, 499, 45, 45, 498, 499, 45, 45, 498, 499, 498, 499, 
            434, 435, 434, 435, 434, 435, 434, 435, 434, 435, 434, 435, 434, 435, 45, 45, 45, 45, 45, 45, 434, 435, 45, 45, 434, 435, 45, 45, 434, 435, 434, 435, 
            498, 499, 498, 499, 498, 499, 498, 499, 498, 499, 498, 499, 498, 499, 45, 45, 45, 45, 45, 45, 498, 499, 45, 45, 498, 499, 45, 45, 498, 499, 498, 499, 
        ]
    }
}