{
    "tilemap": {
        "W": 32,
        "H": 22,
        "tilemap": [
            428, 429, 428, 429, 428, 429, 428, 429, 428, 429, 428, 429, 428, 429, 428, 429, 428, 429, 428, 429, 428, 429, 428, 429, 428, 429, 428, 429, 428, 429, 428, 429, 
            492, 493, 492, 493, 492, 493, 492, 493, 492, 493, 492, 493, 492, 493, 492, 493, 492, 493, 492, 493, 492, 493, 492, 493, 492, 493, 492, 493, 492, 493, 492, 493, 
            428, 429, 428, 429, 428, 429, 428, 429, 428, 429, 428, 429, 428, 429, 428, 429, 428, 429, 428, 429, 428, 429, 428, 429, 430, 431, 426, 427, 428, 429, 428, 429, 
            492, 493, 492, 493, 492, 493, 492, 493, 492, 493, 492, 493, 492, 493, 492, 493, 492, 493, 492, 493, 492, 493, 492, 493, 494, 495, 490, 491, 492, 493, 492, 493, 
            428, 429, 428, 429, 430, 431, 45, 45, 45, 45, 45, 45, 45, 45, 45, 45, 45, 45, 45, 45, 45, 45, 45, 45, 45, 45, 45, 45, 426, 427, 428, 429, 
            492, 493, 492, 493, 494, 495, 45, 45, 45, 45, 45, 45, 45, 45, 45, 45, 45, 45, 45, 45, 45, 45, 45, 45, 45, 45, 45, 45, 490, 491, 492, 493, 
            428, 429, 430, 431, 45, 45, 45, 45, 45, 45, 45, 45, 45, 175, 291, 292, 173, 45, 45, 45, 45, 45, 45, 45, 45, 45, 45, 45, 45, 45, 428, 429, 
            492, 493, 494, 495, 45, 45, 45, 45, 45, 45, 45, 45, 238, 239, 355, 356, 237, 238, 45, 45, 45, 45, 45, 45, 45, 45, 45, 45, 45, 45, 492, 493, 
            428, 429, 45, 45, 45, 45, 416, 417, 45, 45, 416, 417, 289, 290, 00, 00, 288, 289, 416, 417, 45, 45, 416, 417, 45, 45, 45, 45, 45, 45, 428, 429, 
            492, 493, 45, 45, 45, 45, 480, 481, 45, 45, 480, 481, 353, 354, 00, 00, 352, 353, 480, 481, 45, 45, 480, 481, 45, 45, 45, 45, 45, 45, 492, 493, 
            428, 429, 45, 45, 45, 45, 45, 45, 45, 45, 45, 45, 45, 45, 45, 45, 45, 45, 45, 45, 45, 45, 45, 45, 45, 45, 45, 45, 45, 45, 428, 429, 
            492, 493, 45, 45, 45, 45, 45, 45, 45, 45, 45, 45, 45, 45, 45, 45, 45, 45, 45, 45, 45, 45, 45, 45, 45, 45, 45, 45, 45, 45, 492, 493, 
            428, 429, 45, 45, 45, 45, 416, 417, 45, 45, 416, 417, 45, 45, 45, 45, 45, 45, 416, 417, 45, 45, 416, 417, 45, 45, 45, 45, 45, 45, 428, 429, 
            492, 493, 45, 45, 45, 45, 480, 481, 45, 45, 480, 481, 45, 45, 45, 45, 45, 45, 480, 481, 45, 45, 480, 481, 45, 45, 45, 45, 45, 45, 492, 493, 
            428, 429, 424, 425, 45, 45, 45, 45, 45, 45, 45, 45, 45, 45, 45, 45, 45, 45, 45, 45, 45, 45, 45, 45, 45, 45, 45, 45, 45, 45, 428, 429, 
            492, 493, 488, 489, 45, 45, 45, 45, 45, 45, 45, 45, 45, 45, 45, 45, 45, 45, 45, 45, 45, 45, 45, 45, 45, 45, 45, 45, 45, 45, 492, 493, 
            428, 429, 428, 429, 424, 425, 45, 45, 45, 45, 45, 45, 45, 45, 45, 45, 45, 45, 45, 45, 45, 45, 45, 45, 45, 45, 45, 45, 422, 423, 428, 429, 
            492, 493, 492, 493, 488, 489, 45, 45, 45, 45, 45, 45, 45, 45, 45, 45, 45, 45, 45, 45, 45, 45, 45, 45, 45, 45, 45, 45, 486, 487, 492, 493, 
            428, 429, 428, 429, 428, 429, 423, 424, 423, 424, 423, 424, 423, 424, 42, 106, 423, 424, 423, 424, 423, 424, 423, 424, 423, 424, 423, 424, 428, 429, 428, 429, 
            492, 493, 492, 493, 492, 493, 487, 488, 487, 488, 487, 488, 487, 488, 42, 106, 487, 488, 487, 488, 487, 488, 487, 488, 487, 488, 487, 488, 492, 493, 492, 493, 
            428, 429, 428, 429, 428, 429, 428, 429, 428, 429, 428, 429, 428, 429, 42, 106, 428, 429, 428, 429, 428, 429, 428, 429, 428, 429, 428, 429, 428, 429, 428, 429, 
            492, 493, 492, 493, 492, 493, 492, 493, 492, 493, 492, 493, 492, 493, 42, 106, 492, 493, 492, 493, 492, 493, 492, 493, 492, 493, 492, 493, 492, 493, 492, 493, 
        ]
    }
}