{
    "tilemap": {
        "W": 32,
        "H": 22,
        "tilemap": [
            428, 429, 428, 429, 428, 429, 428, 429, 45, 45, 168, 168, 168, 168, 428, 429, 428, 429, 428, 429, 428, 429, 428, 429, 428, 429, 428, 429, 428, 429, 428, 429, 
            492, 493, 492, 493, 492, 493, 492, 493, 45, 45, 168, 168, 168, 168, 492, 493, 492, 493, 492, 493, 492, 493, 492, 493, 492, 493, 492, 493, 492, 493, 492, 493, 
            428, 429, 428, 429, 00, 00, 430, 431, 45, 45, 168, 168, 168, 168, 426, 427, 428, 429, 428, 429, 428, 429, 428, 429, 428, 429, 428, 429, 428, 429, 428, 429, 
            492, 493, 492, 493, 00, 00, 494, 495, 45, 45, 168, 168, 168, 168, 490, 491, 492, 493, 492, 493, 492, 493, 492, 493, 492, 493, 492, 493, 492, 493, 492, 493, 
            428, 429, 430, 431, 45, 45, 45, 45, 45, 45, 168, 168, 168, 168, 45, 45, 45, 45, 45, 45, 45, 45, 45, 45, 45, 45, 45, 45, 45, 45, 45, 45, 
            492, 493, 494, 495, 45, 45, 45, 45, 45, 45, 168, 168, 168, 168, 45, 45, 45, 45, 45, 45, 45, 45, 45, 45, 45, 45, 45, 45, 45, 45, 45, 45, 
            428, 429, 45, 45, 45, 45, 45, 45, 45, 45, 168, 168, 168, 168, 45, 45, 420, 421, 45, 45, 45, 45, 45, 45, 420, 421, 45, 45, 45, 45, 45, 45, 
            492, 493, 45, 45, 45, 45, 45, 45, 45, 45, 168, 168, 168, 168, 45, 45, 484, 485, 45, 45, 45, 45, 45, 45, 484, 485, 45, 45, 45, 45, 45, 45, 
            428, 429, 45, 45, 45, 45, 45, 45, 45, 45, 168, 168, 168, 168, 45, 45, 45, 45, 45, 45, 420, 421, 45, 45, 45, 45, 45, 45, 45, 45, 45, 45, 
            492, 493, 45, 45, 45, 45, 45, 45, 45, 45, 168, 168, 168, 168, 45, 45, 45, 45, 45, 45, 484, 485, 45, 45, 45, 45, 45, 45, 45, 45, 45, 45, 
            428, 429, 45, 45, 45, 45, 420, 421, 45, 45, 168, 168, 168, 168, 45, 45, 420, 421, 45, 45, 45, 45, 45, 45, 420, 421, 45, 45, 45, 45, 45, 45, 
            492, 493, 45, 45, 45, 45, 484, 485, 45, 45, 168, 168, 168, 168, 45, 45, 484, 485, 45, 45, 45, 45, 45, 45, 484, 485, 45, 45, 45, 45, 45, 45, 
            428, 429, 45, 45, 45, 45, 45, 45, 45, 45, 168, 168, 168, 168, 45, 45, 45, 45, 45, 45, 420, 421, 45, 45, 45, 45, 45, 45, 45, 45, 45, 45, 
            492, 493, 45, 45, 45, 45, 45, 45, 45, 45, 168, 168, 168, 168, 45, 45, 45, 45, 45, 45, 484, 485, 45, 45, 45, 45, 45, 45, 45, 45, 45, 45, 
            428, 429, 45, 45, 45, 45, 45, 45, 45, 45, 168, 168, 168, 168, 45, 45, 420, 421, 45, 45, 45, 45, 45, 45, 420, 421, 45, 45, 45, 45, 45, 45, 
            492, 493, 45, 45, 45, 45, 45, 45, 45, 45, 168, 168, 168, 168, 45, 45, 484, 485, 45, 45, 45, 45, 45, 45, 484, 485, 45, 45, 45, 45, 45, 45, 
            428, 429, 424, 425, 45, 45, 45, 45, 45, 45, 168, 168, 168, 168, 45, 45, 45, 45, 45, 45, 45, 45, 45, 45, 45, 45, 45, 45, 45, 45, 45, 45, 
            492, 493, 488, 489, 45, 45, 45, 45, 45, 45, 168, 168, 168, 168, 45, 45, 45, 45, 45, 45, 45, 45, 45, 45, 45, 45, 45, 45, 45, 45, 45, 45, 
            428, 429, 428, 429, 423, 424, 423, 424, 424, 425, 168, 168, 168, 168, 422, 423, 423, 424, 423, 424, 423, 424, 423, 424, 423, 424, 423, 424, 423, 424, 423, 424, 
            492, 493, 492, 493, 487, 488, 487, 488, 488, 489, 168, 168, 168, 168, 486, 487, 487, 488, 487, 488, 487, 488, 487, 488, 487, 488, 487, 488, 487, 488, 487, 488, 
            428, 429, 428, 429, 428, 429, 428, 429, 428, 429, 168, 168, 168, 168, 428, 429, 428, 429, 428, 429, 428, 429, 428, 429, 428, 429, 428, 429, 428, 429, 428, 429, 
            492, 493, 492, 493, 492, 493, 492, 493, 492, 493, 168, 168, 168, 168, 492, 493, 492, 493, 492, 493, 492, 493, 492, 493, 492, 493, 492, 493, 492, 493, 492, 493, 
        ]
    }
}