{
    "tilemap": {
        "W": 32,
        "H": 22,
        "tilemap": [
            418, 419, 418, 419, 418, 419, 418, 419, 418, 419, 418, 419, 418, 419, 45, 45, 45, 45, 167, 168, 168, 168, 168, 168, 168, 168, 168, 168, 168, 168, 168, 168, 
            482, 483, 482, 483, 482, 483, 482, 483, 482, 483, 482, 483, 482, 483, 45, 45, 45, 45, 233, 168, 168, 168, 168, 168, 168, 168, 168, 168, 168, 168, 168, 168, 
            418, 419, 418, 419, 418, 419, 418, 419, 418, 419, 418, 419, 418, 419, 45, 45, 45, 45, 167, 168, 168, 168, 168, 168, 168, 168, 168, 168, 168, 168, 168, 168, 
            482, 483, 482, 483, 482, 483, 482, 483, 482, 483, 482, 483, 482, 483, 45, 45, 45, 45, 233, 168, 168, 168, 168, 168, 168, 168, 168, 168, 168, 168, 168, 168, 
            418, 419, 418, 419, 45, 45, 45, 45, 45, 45, 45, 45, 45, 45, 45, 45, 45, 45, 167, 168, 168, 168, 168, 168, 168, 168, 168, 168, 168, 168, 168, 168, 
            482, 483, 482, 483, 45, 45, 45, 45, 45, 45, 45, 45, 45, 45, 45, 45, 45, 45, 233, 168, 168, 168, 168, 168, 168, 168, 168, 168, 168, 168, 168, 168, 
            418, 419, 418, 419, 45, 45, 45, 45, 45, 45, 418, 419, 45, 45, 45, 45, 45, 45, 167, 168, 168, 168, 168, 168, 168, 168, 168, 168, 168, 168, 168, 168, 
            482, 483, 482, 483, 45, 45, 45, 45, 45, 45, 482, 483, 45, 45, 45, 45, 45, 45, 233, 168, 168, 168, 168, 168, 168, 168, 168, 168, 168, 168, 168, 168, 
            045, 45, 45, 45, 45, 45, 45, 45, 45, 45, 45, 45, 45, 45, 45, 45, 45, 45, 233, 168, 168, 168, 168, 168, 168, 168, 168, 168, 168, 168, 168, 168, 
            045, 45, 45, 45, 45, 45, 45, 45, 45, 45, 45, 45, 45, 45, 45, 45, 45, 45, 170, 164, 164, 164, 164, 164, 164, 164, 164, 164, 164, 164, 164, 164, 
            045, 45, 45, 45, 45, 45, 45, 45, 45, 45, 418, 419, 45, 45, 45, 45, 45, 45, 45, 45, 45, 45, 45, 45, 45, 45, 45, 45, 45, 45, 45, 45, 
            045, 45, 45, 45, 45, 45, 45, 45, 45, 45, 482, 483, 45, 45, 45, 45, 45, 45, 45, 45, 45, 45, 45, 45, 45, 45, 45, 45, 45, 45, 45, 45, 
            045, 45, 45, 45, 45, 45, 45, 45, 45, 45, 45, 45, 45, 45, 45, 45, 45, 45, 45, 45, 45, 45, 45, 45, 45, 45, 45, 45, 423, 424, 423, 424, 
            045, 45, 45, 45, 45, 45, 45, 45, 45, 45, 45, 45, 45, 45, 45, 45, 45, 45, 45, 45, 45, 45, 45, 45, 45, 45, 45, 45, 487, 488, 487, 488, 
            418, 419, 418, 419, 45, 45, 45, 45, 45, 45, 418, 419, 45, 45, 45, 45, 45, 45, 45, 45, 45, 45, 45, 45, 45, 45, 45, 45, 428, 429, 428, 429, 
            482, 483, 482, 483, 45, 45, 45, 45, 45, 45, 482, 483, 45, 45, 45, 45, 45, 45, 45, 45, 45, 45, 45, 45, 45, 45, 45, 45, 492, 493, 492, 493, 
            418, 419, 418, 419, 45, 45, 45, 45, 45, 45, 45, 45, 45, 45, 45, 45, 45, 45, 45, 45, 45, 45, 45, 45, 45, 45, 45, 45, 428, 429, 428, 429, 
            482, 483, 482, 483, 45, 45, 45, 45, 45, 45, 45, 45, 45, 45, 45, 45, 45, 45, 45, 45, 45, 45, 45, 45, 45, 45, 45, 45, 492, 493, 492, 493, 
            418, 419, 418, 419, 418, 419, 45, 45, 45, 45, 418, 419, 418, 419, 418, 419, 418, 419, 45, 45, 45, 45, 418, 419, 418, 419, 45, 45, 428, 429, 428, 429, 
            482, 483, 482, 483, 482, 483, 45, 45, 45, 45, 482, 483, 482, 483, 482, 483, 482, 483, 45, 45, 45, 45, 482, 483, 482, 483, 45, 45, 492, 493, 492, 493, 
            418, 419, 418, 419, 418, 419, 45, 45, 45, 45, 418, 419, 418, 419, 418, 419, 418, 419, 45, 45, 45, 45, 418, 419, 418, 419, 45, 45, 428, 429, 428, 429, 
            482, 483, 482, 483, 482, 483, 45, 45, 45, 45, 482, 483, 482, 483, 482, 483, 482, 483, 45, 45, 45, 45, 482, 483, 482, 483, 45, 45, 492, 493, 492, 493, 
        ]
    }
}