{
    "tilemap": {
        "W": 32,
        "H": 22,
        "tilemap": [
            444, 445, 444, 445, 178, 178, 178, 178, 178, 178, 178, 178, 178, 178, 178, 178, 178, 178, 178, 178, 178, 178, 178, 178, 178, 178, 178, 178, 178, 178, 444, 445, 
            508, 509, 508, 509, 242, 178, 242, 178, 242, 178, 242, 178, 242, 178, 242, 178, 242, 178, 242, 178, 242, 178, 242, 178, 242, 178, 242, 178, 242, 178, 508, 509, 
            444, 445, 444, 445, 178, 178, 178, 178, 178, 178, 178, 178, 178, 178, 178, 178, 178, 178, 178, 178, 178, 178, 178, 178, 178, 178, 178, 178, 178, 178, 444, 445, 
            508, 509, 508, 509, 242, 178, 242, 178, 242, 178, 242, 178, 242, 178, 242, 178, 242, 178, 242, 178, 242, 178, 242, 178, 242, 178, 242, 178, 242, 178, 508, 509, 
            444, 445, 444, 445, 178, 178, 178, 178, 178, 178, 178, 178, 178, 178, 178, 178, 178, 178, 178, 178, 178, 178, 178, 178, 178, 178, 178, 178, 178, 178, 178, 178, 
            508, 509, 508, 509, 242, 178, 242, 178, 242, 178, 242, 178, 242, 178, 242, 178, 242, 178, 242, 178, 242, 178, 242, 178, 242, 178, 242, 178, 242, 178, 242, 178, 
            444, 445, 444, 445, 178, 178, 178, 178, 178, 178, 178, 178, 178, 178, 178, 178, 178, 178, 178, 178, 178, 178, 178, 178, 178, 178, 178, 178, 178, 178, 178, 178, 
            508, 509, 508, 509, 242, 178, 242, 178, 242, 178, 242, 178, 242, 178, 242, 178, 242, 178, 242, 178, 242, 178, 242, 178, 242, 178, 242, 178, 242, 178, 242, 178, 
            444, 445, 444, 445, 178, 178, 178, 178, 178, 178, 178, 178, 178, 178, 178, 178, 178, 178, 178, 178, 178, 178, 178, 178, 178, 178, 178, 178, 178, 178, 178, 178, 
            508, 509, 508, 509, 242, 178, 242, 178, 242, 178, 242, 178, 242, 178, 242, 178, 242, 178, 242, 178, 242, 178, 242, 178, 242, 178, 242, 178, 242, 178, 242, 178, 
            444, 445, 444, 445, 178, 178, 178, 178, 178, 178, 178, 178, 178, 178, 178, 178, 178, 178, 178, 178, 178, 178, 178, 178, 178, 178, 178, 178, 178, 178, 178, 178, 
            508, 509, 508, 509, 242, 178, 242, 178, 242, 178, 242, 178, 242, 178, 242, 178, 242, 178, 242, 178, 242, 178, 242, 178, 242, 178, 242, 178, 242, 178, 242, 178, 
            444, 445, 444, 445, 178, 178, 178, 178, 178, 178, 178, 178, 178, 178, 178, 178, 178, 178, 178, 178, 178, 178, 178, 178, 178, 178, 178, 178, 178, 178, 178, 178, 
            508, 509, 508, 509, 242, 178, 242, 178, 242, 178, 242, 178, 242, 178, 242, 178, 242, 178, 242, 178, 242, 178, 242, 178, 242, 178, 242, 178, 242, 178, 242, 178, 
            444, 445, 444, 445, 178, 178, 178, 178, 178, 178, 178, 178, 178, 178, 178, 178, 178, 178, 178, 178, 178, 178, 178, 178, 178, 178, 178, 178, 178, 178, 178, 178, 
            508, 509, 508, 509, 242, 178, 242, 178, 242, 178, 242, 178, 242, 178, 242, 178, 242, 178, 242, 178, 242, 178, 242, 178, 242, 178, 242, 178, 242, 178, 242, 178, 
            444, 445, 444, 445, 178, 178, 178, 178, 178, 178, 178, 178, 178, 178, 178, 178, 178, 178, 178, 178, 178, 178, 178, 178, 178, 178, 178, 178, 178, 178, 178, 178, 
            508, 509, 508, 509, 242, 178, 242, 178, 242, 178, 242, 178, 242, 178, 242, 178, 242, 178, 242, 178, 242, 178, 242, 178, 242, 178, 242, 178, 242, 178, 242, 178, 
            444, 445, 444, 445, 439, 440, 439, 440, 439, 440, 439, 440, 439, 440, 178, 178, 178, 178, 439, 440, 439, 440, 439, 440, 439, 440, 439, 440, 439, 440, 439, 440, 
            508, 509, 508, 509, 503, 504, 503, 504, 503, 504, 503, 504, 503, 504, 242, 178, 242, 178, 503, 504, 503, 504, 503, 504, 503, 504, 503, 504, 503, 504, 503, 504, 
            444, 445, 444, 445, 444, 445, 444, 445, 444, 445, 444, 445, 444, 445, 178, 178, 178, 178, 444, 445, 444, 445, 444, 445, 444, 445, 444, 445, 444, 445, 444, 445, 
            508, 509, 508, 509, 508, 509, 508, 509, 508, 509, 508, 509, 508, 509, 242, 178, 242, 178, 508, 509, 508, 509, 508, 509, 508, 509, 508, 509, 508, 509, 508, 509, 
        ]
    }
}