{
    "tilemap": {
        "W": 32,
        "H": 22,
        "tilemap": [
            418, 419, 418, 419, 418, 419, 418, 419, 418, 419, 418, 419, 418, 419, 45, 45, 45, 45, 167, 168, 168, 168, 168, 168, 168, 168, 168, 168, 168, 168, 168, 168, 
            482, 483, 482, 483, 482, 483, 482, 483, 482, 483, 482, 483, 482, 483, 45, 45, 45, 45, 233, 168, 168, 168, 168, 168, 168, 168, 168, 168, 168, 168, 168, 168, 
            418, 419, 418, 419, 418, 419, 418, 419, 418, 419, 418, 419, 418, 419, 45, 45, 45, 45, 167, 168, 168, 168, 168, 168, 168, 168, 168, 168, 168, 168, 168, 168, 
            482, 483, 482, 483, 482, 483, 482, 483, 482, 483, 482, 483, 482, 483, 45, 45, 45, 45, 233, 168, 168, 168, 168, 168, 168, 168, 168, 168, 168, 168, 168, 168, 
            418, 419, 418, 419, 45, 45, 45, 45, 45, 45, 45, 45, 45, 45, 45, 45, 45, 45, 167, 168, 168, 168, 168, 168, 168, 168, 168, 168, 168, 168, 168, 168, 
            482, 483, 482, 483, 45, 45, 45, 45, 45, 45, 45, 45, 45, 45, 45, 45, 45, 45, 233, 168, 168, 168, 168, 168, 168, 168, 168, 168, 168, 168, 168, 168, 
            418, 419, 45, 45, 45, 45, 45, 45, 45, 45, 418, 419, 45, 45, 45, 45, 45, 45, 167, 168, 168, 168, 168, 168, 168, 168, 168, 168, 168, 168, 168, 168, 
            482, 483, 45, 45, 45, 45, 45, 45, 45, 45, 482, 483, 45, 45, 45, 45, 45, 45, 233, 168, 168, 168, 168, 168, 168, 168, 168, 168, 168, 168, 168, 168, 
            045, 45, 45, 45, 418, 419, 45, 45, 45, 45, 45, 45, 45, 45, 45, 45, 45, 45, 233, 168, 168, 168, 168, 168, 168, 168, 168, 168, 168, 168, 168, 168, 
            045, 45, 45, 45, 482, 483, 45, 45, 45, 45, 45, 45, 45, 45, 45, 45, 45, 45, 170, 164, 164, 164, 164, 164, 164, 164, 164, 164, 164, 164, 164, 164, 
            045, 45, 45, 45, 45, 45, 45, 45, 45, 45, 418, 419, 45, 45, 45, 45, 45, 45, 45, 45, 45, 45, 45, 45, 45, 45, 45, 45, 45, 45, 45, 45, 
            045, 45, 45, 45, 45, 45, 45, 45, 45, 45, 482, 483, 45, 45, 45, 45, 45, 45, 45, 45, 45, 45, 45, 45, 45, 45, 45, 45, 45, 45, 45, 45, 
            045, 45, 45, 45, 418, 419, 45, 45, 45, 45, 45, 45, 45, 45, 45, 45, 45, 45, 45, 45, 45, 45, 45, 45, 45, 45, 45, 45, 45, 45, 45, 45, 
            045, 45, 45, 45, 482, 483, 45, 45, 45, 45, 45, 45, 45, 45, 45, 45, 45, 45, 45, 45, 45, 45, 45, 45, 45, 45, 45, 45, 45, 45, 45, 45, 
            418, 419, 45, 45, 45, 45, 45, 45, 45, 45, 418, 419, 45, 45, 45, 45, 45, 45, 45, 45, 45, 45, 45, 45, 45, 45, 45, 45, 45, 45, 45, 45, 
            482, 483, 45, 45, 45, 45, 45, 45, 45, 45, 482, 483, 45, 45, 45, 45, 45, 45, 45, 45, 45, 45, 45, 45, 45, 45, 45, 45, 45, 45, 45, 45, 
            418, 419, 418, 419, 45, 45, 45, 45, 45, 45, 45, 45, 45, 45, 45, 45, 45, 45, 45, 45, 45, 45, 45, 45, 45, 45, 45, 45, 45, 45, 45, 45, 
            482, 483, 482, 483, 45, 45, 45, 45, 45, 45, 45, 45, 45, 45, 45, 45, 45, 45, 45, 45, 45, 45, 45, 45, 45, 45, 45, 45, 45, 45, 45, 45, 
            418, 419, 418, 419, 418, 419, 418, 419, 418, 419, 418, 419, 418, 419, 418, 419, 418, 419, 418, 419, 418, 419, 418, 419, 418, 419, 418, 419, 418, 419, 418, 419, 
            482, 483, 482, 483, 482, 483, 482, 483, 482, 483, 482, 483, 482, 483, 482, 483, 482, 483, 482, 483, 482, 483, 482, 483, 482, 483, 482, 483, 482, 483, 482, 483, 
            418, 419, 418, 419, 418, 419, 418, 419, 418, 419, 418, 419, 418, 419, 418, 419, 418, 419, 418, 419, 418, 419, 418, 419, 418, 419, 418, 419, 418, 419, 418, 419, 
            482, 483, 482, 483, 482, 483, 482, 483, 482, 483, 482, 483, 482, 483, 482, 483, 482, 483, 482, 483, 482, 483, 482, 483, 482, 483, 482, 483, 482, 483, 482, 483, 
        ]
    }
}