{
    "tilemap": {
        "W": 32,
        "H": 22,
        "tilemap": [
            428, 429, 428, 429, 418, 419, 45, 45, 418, 419, 45, 45, 418, 419, 45, 45, 45, 45, 418, 419, 45, 45, 418, 419, 45, 45, 418, 419, 45, 45, 418, 419, 
            492, 493, 492, 493, 482, 483, 45, 45, 482, 483, 45, 45, 482, 483, 45, 45, 45, 45, 482, 483, 45, 45, 482, 483, 45, 45, 482, 483, 45, 45, 482, 483, 
            428, 429, 428, 429, 418, 419, 45, 45, 418, 419, 45, 45, 418, 419, 45, 45, 45, 45, 418, 419, 45, 45, 418, 419, 45, 45, 418, 419, 45, 45, 418, 419, 
            492, 493, 492, 493, 482, 483, 45, 45, 482, 483, 45, 45, 482, 483, 45, 45, 45, 45, 482, 483, 45, 45, 482, 483, 45, 45, 482, 483, 45, 45, 482, 483, 
            428, 429, 428, 429, 45, 45, 45, 45, 45, 45, 45, 45, 45, 45, 45, 45, 45, 45, 45, 45, 45, 45, 45, 45, 45, 45, 45, 45, 45, 45, 45, 45, 
            492, 493, 492, 493, 45, 45, 45, 45, 45, 45, 45, 45, 45, 45, 45, 45, 45, 45, 45, 45, 45, 45, 45, 45, 45, 45, 45, 45, 45, 45, 45, 45, 
            428, 429, 430, 431, 45, 45, 45, 45, 45, 45, 45, 45, 418, 419, 45, 45, 45, 45, 418, 419, 45, 45, 418, 419, 45, 45, 418, 419, 45, 45, 45, 45, 
            492, 493, 494, 495, 45, 45, 45, 45, 45, 45, 45, 45, 482, 483, 45, 45, 45, 45, 482, 483, 45, 45, 482, 483, 45, 45, 482, 483, 45, 45, 45, 45, 
            430, 431, 45, 45, 418, 419, 45, 45, 418, 419, 45, 45, 45, 45, 45, 45, 45, 45, 45, 45, 45, 45, 45, 45, 45, 45, 45, 45, 45, 45, 45, 45, 
            494, 495, 45, 45, 482, 483, 45, 45, 482, 483, 45, 45, 45, 45, 45, 45, 45, 45, 45, 45, 45, 45, 45, 45, 45, 45, 45, 45, 45, 45, 45, 45, 
            045, 45, 45, 45, 45, 45, 45, 45, 45, 45, 45, 45, 418, 419, 45, 45, 45, 45, 418, 419, 45, 45, 418, 419, 45, 45, 418, 419, 45, 45, 45, 45, 
            045, 45, 45, 45, 45, 45, 45, 45, 45, 45, 45, 45, 482, 483, 45, 45, 45, 45, 482, 483, 45, 45, 482, 483, 45, 45, 482, 483, 45, 45, 45, 45, 
            424, 425, 45, 45, 418, 419, 45, 45, 418, 419, 45, 45, 45, 45, 45, 45, 45, 45, 45, 45, 45, 45, 45, 45, 45, 45, 45, 45, 45, 45, 45, 45, 
            488, 489, 45, 45, 482, 483, 45, 45, 482, 483, 45, 45, 45, 45, 45, 45, 45, 45, 45, 45, 45, 45, 45, 45, 45, 45, 45, 45, 45, 45, 45, 45, 
            428, 429, 424, 425, 45, 45, 45, 45, 45, 45, 45, 45, 418, 419, 45, 45, 45, 45, 418, 419, 45, 45, 418, 419, 45, 45, 418, 419, 45, 45, 45, 45, 
            492, 493, 488, 489, 45, 45, 45, 45, 45, 45, 45, 45, 482, 483, 45, 45, 45, 45, 482, 483, 45, 45, 482, 483, 45, 45, 482, 483, 45, 45, 45, 45, 
            428, 429, 428, 429, 45, 45, 45, 45, 45, 45, 45, 45, 45, 45, 45, 45, 45, 45, 45, 45, 45, 45, 45, 45, 45, 45, 45, 45, 45, 45, 45, 45, 
            492, 493, 492, 493, 45, 45, 45, 45, 45, 45, 45, 45, 45, 45, 45, 45, 45, 45, 45, 45, 45, 45, 45, 45, 45, 45, 45, 45, 45, 45, 45, 45, 
            428, 429, 428, 429, 418, 419, 418, 419, 418, 419, 418, 419, 418, 419, 418, 419, 418, 419, 418, 419, 418, 419, 418, 419, 418, 419, 418, 419, 418, 419, 418, 419, 
            492, 493, 492, 493, 482, 483, 482, 483, 482, 483, 482, 483, 482, 483, 482, 483, 482, 483, 482, 483, 482, 483, 482, 483, 482, 483, 482, 483, 482, 483, 482, 483, 
            428, 429, 428, 429, 418, 419, 418, 419, 418, 419, 418, 419, 418, 419, 418, 419, 418, 419, 418, 419, 418, 419, 418, 419, 418, 419, 418, 419, 418, 419, 418, 419, 
            492, 493, 492, 493, 482, 483, 482, 483, 482, 483, 482, 483, 482, 483, 482, 483, 482, 483, 482, 483, 482, 483, 482, 483, 482, 483, 482, 483, 482, 483, 482, 483, 
        ]
    }
}