{
    "tilemap": {
        "W": 32,
        "H": 22,
        "tilemap": [
            396, 397, 396, 397, 13, 13, 13, 13, 13, 13, 13, 13, 13, 13, 13, 13, 13, 13, 13, 13, 13, 13, 13, 13, 13, 13, 13, 13, 396, 397, 396, 397, 
            460, 461, 460, 461, 13, 13, 13, 13, 13, 13, 13, 13, 13, 13, 13, 13, 13, 13, 13, 13, 13, 13, 13, 13, 13, 13, 13, 13, 460, 461, 460, 461, 
            396, 397, 396, 397, 13, 13, 13, 13, 13, 13, 13, 13, 13, 13, 13, 13, 13, 13, 13, 13, 13, 13, 13, 13, 13, 13, 13, 13, 394, 395, 396, 397, 
            460, 461, 460, 461, 13, 13, 13, 13, 13, 13, 13, 13, 13, 13, 13, 13, 13, 13, 13, 13, 13, 13, 13, 13, 13, 13, 13, 13, 458, 459, 460, 461, 
            396, 397, 396, 397, 13, 13, 13, 13, 13, 13, 13, 13, 13, 13, 13, 13, 13, 13, 13, 13, 13, 13, 13, 13, 13, 13, 13, 13, 13, 13, 13, 13, 
            460, 461, 460, 461, 13, 13, 13, 13, 13, 13, 13, 13, 13, 13, 13, 13, 13, 13, 13, 13, 13, 13, 13, 13, 13, 13, 13, 13, 13, 13, 13, 13, 
            396, 397, 396, 397, 13, 13, 270, 271, 13, 13, 13, 13, 270, 271, 13, 13, 13, 13, 270, 271, 13, 13, 13, 13, 270, 271, 13, 13, 13, 13, 13, 13, 
            460, 461, 460, 461, 13, 13, 334, 335, 13, 13, 13, 13, 334, 335, 13, 13, 13, 13, 334, 335, 13, 13, 13, 13, 334, 335, 13, 13, 13, 13, 13, 13, 
            396, 397, 396, 397, 13, 13, 13, 13, 13, 13, 13, 13, 13, 13, 13, 13, 13, 13, 13, 13, 13, 13, 13, 13, 13, 13, 13, 13, 13, 13, 13, 13, 
            460, 461, 460, 461, 13, 13, 13, 13, 13, 13, 13, 13, 13, 13, 13, 13, 13, 13, 13, 13, 13, 13, 13, 13, 13, 13, 13, 13, 13, 13, 13, 13, 
            396, 397, 396, 397, 13, 13, 270, 271, 13, 13, 13, 13, 270, 271, 13, 13, 13, 13, 270, 271, 13, 13, 13, 13, 270, 271, 13, 13, 13, 13, 13, 13, 
            460, 461, 460, 461, 13, 13, 334, 335, 13, 13, 13, 13, 334, 335, 13, 13, 13, 13, 334, 335, 13, 13, 13, 13, 334, 335, 13, 13, 13, 13, 13, 13, 
            396, 397, 396, 397, 13, 13, 13, 13, 13, 13, 13, 13, 13, 13, 13, 13, 13, 13, 13, 13, 13, 13, 13, 13, 13, 13, 13, 13, 13, 13, 13, 13, 
            460, 461, 460, 461, 13, 13, 13, 13, 13, 13, 13, 13, 13, 13, 13, 13, 13, 13, 13, 13, 13, 13, 13, 13, 13, 13, 13, 13, 13, 13, 13, 13, 
            396, 397, 396, 397, 13, 13, 270, 271, 13, 13, 13, 13, 270, 271, 13, 13, 13, 13, 270, 271, 13, 13, 13, 13, 270, 271, 13, 13, 13, 13, 13, 13, 
            460, 461, 460, 461, 13, 13, 334, 335, 13, 13, 13, 13, 334, 335, 13, 13, 13, 13, 334, 335, 13, 13, 13, 13, 334, 335, 13, 13, 13, 13, 13, 13, 
            396, 397, 396, 397, 13, 13, 13, 13, 13, 13, 13, 13, 13, 13, 13, 13, 13, 13, 13, 13, 13, 13, 13, 13, 13, 13, 13, 13, 13, 13, 13, 13, 
            460, 461, 460, 461, 13, 13, 13, 13, 13, 13, 13, 13, 13, 13, 13, 13, 13, 13, 13, 13, 13, 13, 13, 13, 13, 13, 13, 13, 13, 13, 13, 13, 
            396, 397, 396, 397, 13, 13, 13, 13, 13, 13, 13, 13, 13, 13, 13, 13, 13, 13, 13, 13, 13, 13, 13, 13, 13, 13, 13, 13, 390, 391, 391, 392, 
            460, 461, 460, 461, 13, 13, 13, 13, 13, 13, 13, 13, 13, 13, 13, 13, 13, 13, 13, 13, 13, 13, 13, 13, 13, 13, 13, 13, 454, 455, 455, 456, 
            396, 397, 396, 397, 13, 13, 13, 13, 13, 13, 13, 13, 13, 13, 13, 13, 13, 13, 13, 13, 13, 13, 13, 13, 13, 13, 13, 13, 396, 397, 396, 397, 
            460, 461, 460, 461, 13, 13, 13, 13, 13, 13, 13, 13, 13, 13, 13, 13, 13, 13, 13, 13, 13, 13, 13, 13, 13, 13, 13, 13, 460, 461, 460, 461, 
        ]
    }
}