{
    "tilemap": {
        "W": 32,
        "H": 22,
        "tilemap": [
            444, 445, 444, 445, 58, 122, 444, 445, 444, 445, 444, 445, 444, 445, 45, 45, 45, 45, 183, 184, 184, 184, 184, 184, 184, 184, 184, 184, 184, 184, 184, 184, 
            508, 509, 508, 509, 58, 122, 508, 509, 508, 509, 508, 509, 508, 509, 45, 45, 45, 45, 249, 184, 184, 184, 184, 184, 184, 184, 184, 184, 184, 184, 184, 184, 
            444, 445, 444, 445, 58, 122, 444, 445, 444, 445, 444, 445, 446, 447, 45, 45, 45, 45, 183, 184, 184, 184, 184, 184, 184, 184, 184, 184, 184, 184, 184, 184, 
            508, 509, 508, 509, 58, 122, 508, 509, 508, 509, 508, 509, 510, 495, 45, 45, 45, 45, 249, 184, 184, 184, 184, 184, 184, 184, 184, 184, 184, 184, 184, 184, 
            444, 445, 444, 445, 58, 122, 444, 445, 45, 45, 45, 45, 45, 45, 45, 45, 45, 45, 183, 184, 184, 184, 184, 184, 184, 184, 184, 184, 184, 184, 184, 184, 
            508, 509, 508, 509, 58, 122, 508, 509, 45, 45, 45, 45, 45, 45, 45, 45, 45, 45, 249, 184, 184, 184, 184, 184, 184, 184, 184, 184, 184, 184, 184, 184, 
            444, 445, 444, 445, 58, 122, 444, 445, 45, 45, 45, 45, 45, 45, 45, 45, 45, 45, 183, 184, 184, 184, 184, 184, 184, 184, 184, 184, 184, 184, 184, 184, 
            508, 509, 508, 509, 58, 122, 508, 509, 45, 45, 45, 45, 45, 45, 45, 45, 45, 45, 249, 184, 184, 184, 184, 184, 184, 184, 184, 184, 184, 184, 184, 184, 
            444, 445, 444, 445, 58, 122, 446, 447, 45, 45, 45, 45, 45, 45, 45, 45, 45, 45, 249, 184, 184, 184, 184, 184, 184, 184, 184, 184, 184, 184, 184, 184, 
            508, 509, 508, 509, 58, 122, 510, 495, 45, 45, 45, 45, 45, 45, 45, 45, 45, 45, 186, 180, 180, 180, 180, 180, 180, 180, 180, 180, 180, 180, 180, 180, 
            045, 45, 45, 45, 45, 45, 45, 45, 45, 45, 45, 45, 45, 45, 45, 45, 45, 45, 45, 45, 45, 45, 45, 45, 45, 45, 45, 45, 45, 45, 45, 45, 
            045, 45, 45, 45, 45, 45, 45, 45, 45, 45, 45, 45, 45, 45, 45, 45, 45, 45, 45, 45, 45, 45, 45, 45, 45, 45, 45, 45, 45, 45, 45, 45, 
            045, 45, 45, 45, 45, 45, 45, 45, 45, 45, 45, 45, 45, 45, 45, 45, 45, 45, 45, 45, 45, 45, 45, 45, 45, 45, 45, 45, 45, 45, 45, 45, 
            045, 45, 45, 45, 45, 45, 45, 45, 45, 45, 45, 45, 45, 45, 45, 45, 45, 45, 45, 45, 45, 45, 45, 45, 45, 45, 45, 45, 45, 45, 45, 45, 
            045, 45, 45, 45, 45, 45, 45, 45, 45, 45, 45, 45, 45, 45, 45, 45, 45, 45, 45, 45, 45, 45, 45, 45, 45, 45, 45, 45, 45, 45, 45, 45, 
            045, 45, 45, 45, 45, 45, 45, 45, 45, 45, 45, 45, 45, 45, 45, 45, 45, 45, 45, 45, 45, 45, 45, 45, 45, 45, 45, 45, 45, 45, 45, 45, 
            045, 45, 45, 45, 45, 45, 45, 45, 45, 45, 45, 45, 45, 45, 45, 45, 45, 45, 45, 45, 45, 45, 45, 45, 45, 45, 45, 45, 45, 45, 45, 45, 
            045, 45, 45, 45, 45, 45, 45, 45, 45, 45, 45, 45, 45, 45, 45, 45, 45, 45, 45, 45, 45, 45, 45, 45, 45, 45, 45, 45, 45, 45, 45, 45, 
            439, 440, 439, 440, 439, 440, 439, 440, 439, 440, 439, 440, 440, 441, 45, 45, 45, 45, 439, 440, 439, 440, 439, 440, 439, 440, 439, 440, 439, 440, 439, 440, 
            503, 504, 503, 504, 503, 504, 503, 504, 503, 504, 503, 504, 504, 505, 45, 45, 45, 45, 503, 504, 503, 504, 503, 504, 503, 504, 503, 504, 503, 504, 503, 504, 
            444, 445, 444, 445, 444, 445, 444, 445, 444, 445, 444, 445, 444, 445, 45, 45, 45, 45, 444, 445, 444, 445, 444, 445, 444, 445, 444, 445, 444, 445, 444, 445, 
            508, 509, 508, 509, 508, 509, 508, 509, 508, 509, 508, 509, 508, 509, 45, 45, 45, 45, 508, 509, 508, 509, 508, 509, 508, 509, 508, 509, 508, 509, 508, 509, 
        ]
    }
}