{
    "tilemap": {
        "W": 32,
        "H": 22,
        "tilemap": [
            168, 168, 168, 168, 168, 168, 168, 168, 168, 168, 168, 168, 168, 169, 45, 45, 45, 45, 45, 45, 45, 45, 418, 419, 418, 419, 418, 419, 45, 45, 418, 419, 
            168, 168, 168, 168, 168, 168, 168, 168, 168, 168, 168, 168, 168, 235, 45, 45, 45, 45, 45, 45, 45, 45, 482, 483, 482, 483, 482, 483, 45, 45, 482, 483, 
            168, 168, 168, 168, 168, 168, 168, 168, 168, 168, 168, 168, 168, 169, 45, 45, 45, 45, 45, 45, 45, 45, 418, 419, 418, 419, 418, 419, 45, 45, 418, 419, 
            168, 168, 168, 168, 168, 168, 168, 168, 168, 168, 168, 168, 168, 235, 45, 45, 45, 45, 45, 45, 45, 45, 482, 483, 482, 483, 482, 483, 45, 45, 482, 483, 
            168, 168, 168, 168, 168, 168, 168, 168, 168, 168, 168, 168, 168, 169, 45, 45, 45, 45, 45, 45, 45, 45, 45, 45, 45, 45, 45, 45, 45, 45, 45, 45, 
            168, 168, 168, 168, 168, 168, 168, 168, 168, 168, 168, 168, 168, 235, 45, 45, 45, 45, 45, 45, 45, 45, 45, 45, 45, 45, 45, 45, 45, 45, 45, 45, 
            168, 168, 168, 168, 168, 168, 168, 168, 168, 168, 168, 168, 168, 169, 45, 45, 45, 45, 45, 45, 45, 45, 45, 45, 45, 45, 45, 45, 45, 45, 45, 45, 
            168, 168, 168, 168, 168, 168, 168, 168, 168, 168, 168, 168, 168, 235, 45, 45, 45, 45, 45, 45, 45, 45, 45, 45, 45, 45, 45, 45, 45, 45, 45, 45, 
            168, 168, 168, 168, 168, 168, 168, 168, 168, 168, 168, 168, 168, 235, 45, 45, 45, 45, 45, 45, 45, 45, 45, 45, 418, 419, 45, 45, 45, 45, 45, 45, 
            164, 164, 164, 164, 164, 164, 164, 164, 164, 164, 164, 164, 164, 172, 45, 45, 45, 45, 45, 45, 45, 45, 45, 45, 482, 483, 45, 45, 45, 45, 45, 45, 
            045, 45, 45, 45, 45, 45, 45, 45, 45, 45, 45, 45, 45, 45, 45, 45, 45, 45, 45, 45, 45, 45, 45, 45, 45, 45, 45, 45, 45, 45, 45, 45, 
            045, 45, 45, 45, 45, 45, 45, 45, 45, 45, 45, 45, 45, 45, 45, 45, 45, 45, 45, 45, 45, 45, 45, 45, 45, 45, 45, 45, 45, 45, 45, 45, 
            045, 45, 45, 45, 45, 45, 45, 45, 45, 45, 45, 45, 45, 45, 45, 45, 45, 45, 45, 45, 45, 45, 45, 45, 418, 419, 45, 45, 45, 45, 45, 45, 
            045, 45, 45, 45, 45, 45, 45, 45, 45, 45, 45, 45, 45, 45, 45, 45, 45, 45, 45, 45, 45, 45, 45, 45, 482, 483, 45, 45, 45, 45, 45, 45, 
            045, 45, 45, 45, 45, 45, 45, 45, 45, 45, 45, 45, 45, 45, 45, 45, 45, 45, 45, 45, 45, 45, 45, 45, 45, 45, 45, 45, 45, 45, 45, 45, 
            045, 45, 45, 45, 45, 45, 45, 45, 45, 45, 45, 45, 45, 45, 45, 45, 45, 45, 45, 45, 45, 45, 45, 45, 45, 45, 45, 45, 45, 45, 45, 45, 
            045, 45, 45, 45, 45, 45, 45, 45, 45, 45, 45, 45, 45, 45, 45, 45, 45, 45, 45, 45, 45, 45, 45, 45, 45, 45, 45, 45, 45, 45, 45, 45, 
            045, 45, 45, 45, 45, 45, 45, 45, 45, 45, 45, 45, 45, 45, 45, 45, 45, 45, 45, 45, 45, 45, 45, 45, 45, 45, 45, 45, 45, 45, 45, 45, 
            418, 419, 418, 419, 418, 419, 418, 419, 418, 419, 418, 419, 418, 419, 418, 419, 418, 419, 418, 419, 418, 419, 418, 419, 418, 419, 418, 419, 418, 419, 418, 419, 
            482, 483, 482, 483, 482, 483, 482, 483, 482, 483, 482, 483, 482, 483, 482, 483, 482, 483, 482, 483, 482, 483, 482, 483, 482, 483, 482, 483, 482, 483, 482, 483, 
            418, 419, 418, 419, 418, 419, 418, 419, 418, 419, 418, 419, 418, 419, 418, 419, 418, 419, 418, 419, 418, 419, 418, 419, 418, 419, 418, 419, 418, 419, 418, 419, 
            482, 483, 482, 483, 482, 483, 482, 483, 482, 483, 482, 483, 482, 483, 482, 483, 482, 483, 482, 483, 482, 483, 482, 483, 482, 483, 482, 483, 482, 483, 482, 483, 
        ]
    }
}