{
    "tilemap": {
        "W": 32,
        "H": 22,
        "tilemap": [
            444, 445, 444, 445, 444, 445, 444, 445, 444, 445, 444, 445, 58, 122, 444, 445, 444, 445, 444, 445, 444, 445, 444, 445, 444, 445, 58, 122, 444, 445, 444, 445, 
            508, 509, 508, 509, 508, 509, 508, 509, 508, 509, 508, 509, 58, 122, 508, 509, 508, 509, 508, 509, 508, 509, 508, 509, 508, 509, 58, 122, 508, 509, 508, 509, 
            444, 445, 444, 445, 444, 445, 444, 445, 444, 445, 444, 445, 58, 122, 444, 445, 444, 445, 444, 445, 444, 445, 444, 445, 444, 445, 58, 122, 444, 445, 444, 445, 
            508, 509, 508, 509, 508, 509, 508, 509, 508, 509, 508, 509, 58, 122, 508, 509, 508, 509, 508, 509, 508, 509, 508, 509, 508, 509, 58, 122, 508, 509, 508, 509, 
            444, 445, 444, 445, 13, 13, 13, 13, 13, 13, 13, 13, 13, 13, 13, 13, 13, 13, 13, 13, 13, 13, 13, 13, 13, 13, 13, 13, 444, 445, 444, 445, 
            508, 509, 508, 509, 13, 13, 13, 13, 13, 13, 13, 13, 13, 13, 13, 13, 13, 13, 13, 13, 13, 13, 13, 13, 13, 13, 13, 13, 508, 509, 508, 509, 
            444, 445, 444, 445, 13, 13, 13, 13, 13, 13, 13, 13, 13, 13, 13, 13, 13, 13, 13, 13, 13, 13, 13, 13, 13, 13, 13, 13, 444, 445, 444, 445, 
            508, 509, 508, 509, 13, 13, 13, 13, 13, 13, 13, 13, 13, 13, 13, 13, 13, 13, 13, 13, 13, 13, 13, 13, 13, 13, 13, 13, 508, 509, 508, 509, 
            444, 445, 446, 447, 13, 13, 384, 385, 13, 13, 384, 385, 13, 13, 384, 385, 13, 13, 384, 385, 13, 13, 384, 385, 13, 13, 13, 13, 444, 445, 444, 445, 
            508, 509, 510, 495, 13, 13, 448, 449, 13, 13, 448, 449, 13, 13, 448, 449, 13, 13, 448, 449, 13, 13, 448, 449, 13, 13, 13, 13, 508, 509, 508, 509, 
            045, 45, 45, 45, 13, 13, 13, 13, 13, 13, 13, 13, 13, 13, 13, 13, 13, 13, 13, 13, 13, 13, 13, 13, 13, 13, 13, 13, 444, 445, 444, 445, 
            045, 45, 45, 45, 13, 13, 13, 13, 13, 13, 13, 13, 13, 13, 13, 13, 13, 13, 13, 13, 13, 13, 13, 13, 13, 13, 13, 13, 508, 509, 508, 509, 
            439, 440, 440, 441, 13, 13, 384, 385, 13, 13, 384, 385, 13, 13, 384, 385, 13, 13, 384, 385, 13, 13, 384, 385, 13, 13, 13, 13, 444, 445, 444, 445, 
            503, 504, 504, 505, 13, 13, 448, 449, 13, 13, 448, 449, 13, 13, 448, 449, 13, 13, 448, 449, 13, 13, 448, 449, 13, 13, 13, 13, 508, 509, 508, 509, 
            444, 445, 444, 445, 13, 13, 13, 13, 13, 13, 13, 13, 13, 13, 13, 13, 13, 13, 13, 13, 13, 13, 13, 13, 13, 13, 13, 13, 444, 445, 444, 445, 
            508, 509, 508, 509, 13, 13, 13, 13, 13, 13, 13, 13, 13, 13, 13, 13, 13, 13, 13, 13, 13, 13, 13, 13, 13, 13, 13, 13, 508, 509, 508, 509, 
            444, 445, 444, 445, 13, 13, 13, 13, 13, 13, 13, 13, 13, 13, 13, 13, 13, 13, 13, 13, 13, 13, 13, 13, 13, 13, 13, 13, 444, 445, 444, 445, 
            508, 509, 508, 509, 13, 13, 13, 13, 13, 13, 13, 13, 13, 13, 13, 13, 13, 13, 13, 13, 13, 13, 13, 13, 13, 13, 13, 13, 508, 509, 508, 509, 
            444, 445, 444, 445, 439, 440, 439, 440, 439, 440, 439, 440, 439, 440, 439, 440, 439, 440, 439, 440, 439, 440, 439, 440, 439, 440, 439, 440, 444, 445, 444, 445, 
            508, 509, 508, 509, 503, 504, 503, 504, 503, 504, 503, 504, 503, 504, 503, 504, 503, 504, 503, 504, 503, 504, 503, 504, 503, 504, 503, 504, 508, 509, 508, 509, 
            444, 445, 444, 445, 444, 445, 444, 445, 444, 445, 444, 445, 444, 445, 444, 445, 444, 445, 444, 445, 444, 445, 444, 445, 444, 445, 444, 445, 444, 445, 444, 445, 
            508, 509, 508, 509, 508, 509, 508, 509, 508, 509, 508, 509, 508, 509, 508, 509, 508, 509, 508, 509, 508, 509, 508, 509, 508, 509, 508, 509, 508, 509, 508, 509, 
        ]
    }
}