{
    "tilemap": {
        "W": 32,
        "H": 22,
        "tilemap": [
            444, 445, 444, 445, 444, 445, 444, 445, 444, 445, 444, 445, 444, 445, 444, 445, 444, 445, 444, 445, 444, 445, 444, 445, 444, 445, 444, 445, 444, 445, 444, 445, 
            508, 509, 508, 509, 508, 509, 508, 509, 508, 509, 508, 509, 508, 509, 508, 509, 508, 509, 508, 509, 508, 509, 508, 509, 508, 509, 508, 509, 508, 509, 508, 509, 
            444, 445, 444, 445, 444, 445, 444, 445, 444, 445, 444, 445, 444, 445, 444, 445, 444, 445, 444, 445, 444, 445, 00, 00, 444, 445, 444, 445, 444, 445, 444, 445, 
            508, 509, 508, 509, 508, 509, 508, 509, 508, 509, 508, 509, 508, 509, 508, 509, 508, 509, 508, 509, 508, 509, 00, 00, 508, 509, 508, 509, 508, 509, 508, 509, 
            444, 445, 444, 445, 444, 445, 446, 447, 45, 45, 45, 45, 45, 45, 45, 45, 45, 45, 45, 45, 45, 45, 45, 45, 45, 45, 45, 45, 45, 45, 45, 45, 
            508, 509, 508, 509, 508, 509, 510, 495, 45, 45, 45, 45, 45, 45, 45, 45, 45, 45, 45, 45, 45, 45, 45, 45, 45, 45, 45, 45, 45, 45, 45, 45, 
            444, 445, 444, 445, 446, 447, 45, 45, 45, 45, 312, 313, 309, 45, 45, 45, 312, 313, 309, 45, 45, 45, 45, 45, 45, 45, 45, 45, 45, 45, 45, 45, 
            508, 509, 508, 509, 510, 495, 45, 45, 45, 45, 376, 377, 373, 45, 45, 45, 376, 377, 373, 45, 45, 45, 45, 45, 45, 45, 45, 45, 45, 45, 45, 45, 
            444, 445, 446, 447, 45, 45, 45, 45, 45, 45, 45, 311, 316, 317, 45, 45, 45, 311, 316, 317, 45, 45, 45, 45, 45, 45, 45, 45, 45, 45, 45, 45, 
            508, 509, 510, 495, 45, 45, 45, 45, 45, 45, 45, 375, 380, 381, 45, 45, 45, 375, 380, 381, 45, 45, 45, 45, 45, 45, 45, 45, 45, 45, 45, 45, 
            444, 445, 45, 45, 45, 45, 45, 45, 45, 45, 45, 45, 45, 45, 45, 45, 45, 45, 45, 45, 45, 45, 45, 45, 45, 45, 45, 45, 45, 45, 45, 45, 
            508, 509, 45, 45, 45, 45, 45, 45, 45, 45, 45, 45, 45, 45, 45, 45, 45, 45, 45, 45, 45, 45, 45, 45, 45, 45, 45, 45, 45, 45, 45, 45, 
            444, 445, 440, 441, 45, 45, 45, 45, 45, 45, 45, 45, 312, 313, 309, 45, 45, 45, 312, 313, 309, 45, 45, 45, 45, 45, 45, 45, 45, 45, 45, 45, 
            508, 509, 504, 505, 45, 45, 45, 45, 45, 45, 45, 45, 376, 377, 373, 45, 45, 45, 376, 377, 373, 45, 45, 45, 45, 45, 45, 45, 45, 45, 45, 45, 
            444, 445, 444, 445, 440, 441, 45, 45, 45, 45, 45, 45, 45, 311, 316, 317, 45, 45, 45, 311, 316, 317, 45, 45, 45, 45, 45, 45, 45, 45, 45, 45, 
            508, 509, 508, 509, 504, 505, 45, 45, 45, 45, 45, 45, 45, 375, 380, 381, 45, 45, 45, 375, 380, 381, 45, 45, 45, 45, 45, 45, 45, 45, 45, 45, 
            444, 445, 444, 445, 444, 445, 440, 441, 45, 45, 45, 45, 45, 45, 45, 45, 45, 45, 45, 45, 45, 45, 45, 45, 45, 45, 45, 45, 45, 45, 45, 45, 
            508, 509, 508, 509, 508, 509, 504, 505, 45, 45, 45, 45, 45, 45, 45, 45, 45, 45, 45, 45, 45, 45, 45, 45, 45, 45, 45, 45, 45, 45, 45, 45, 
            444, 445, 444, 445, 444, 445, 444, 445, 439, 440, 439, 440, 439, 440, 439, 440, 439, 440, 439, 440, 439, 440, 439, 440, 439, 440, 439, 440, 439, 440, 439, 440, 
            508, 509, 508, 509, 508, 509, 508, 509, 503, 504, 503, 504, 503, 504, 503, 504, 503, 504, 503, 504, 503, 504, 503, 504, 503, 504, 503, 504, 503, 504, 503, 504, 
            444, 445, 444, 445, 444, 445, 444, 445, 444, 445, 444, 445, 444, 445, 444, 445, 444, 445, 444, 445, 444, 445, 444, 445, 444, 445, 444, 445, 444, 445, 444, 445, 
            508, 509, 508, 509, 508, 509, 508, 509, 508, 509, 508, 509, 508, 509, 508, 509, 508, 509, 508, 509, 508, 509, 508, 509, 508, 509, 508, 509, 508, 509, 508, 509, 
        ]
    }
}