{
    "tilemap": {
        "W": 32,
        "H": 22,
        "tilemap": [
            444, 445, 444, 445, 444, 445, 444, 445, 444, 445, 444, 445, 444, 445, 444, 445, 45, 45, 183, 184, 184, 184, 184, 184, 184, 184, 184, 184, 184, 184, 184, 184, 
            508, 509, 508, 509, 508, 509, 508, 509, 508, 509, 508, 509, 508, 509, 508, 509, 45, 45, 249, 184, 184, 184, 184, 184, 184, 184, 184, 184, 184, 184, 184, 184, 
            444, 445, 444, 445, 444, 445, 444, 445, 00, 00, 444, 445, 444, 445, 444, 445, 45, 45, 183, 184, 184, 184, 184, 184, 184, 184, 184, 184, 184, 184, 184, 184, 
            508, 509, 508, 509, 508, 509, 508, 509, 00, 00, 508, 509, 508, 509, 508, 509, 45, 45, 249, 184, 184, 184, 184, 184, 184, 184, 184, 184, 184, 184, 184, 184, 
            444, 445, 446, 447, 45, 45, 45, 45, 45, 45, 45, 45, 45, 45, 45, 45, 45, 45, 167, 168, 168, 168, 168, 168, 168, 168, 168, 168, 184, 184, 184, 184, 
            508, 509, 510, 495, 45, 45, 45, 45, 45, 45, 45, 45, 45, 45, 45, 45, 45, 45, 233, 168, 168, 168, 168, 168, 168, 168, 168, 168, 184, 184, 184, 184, 
            444, 445, 45, 45, 45, 45, 45, 45, 45, 45, 45, 45, 45, 45, 45, 45, 45, 45, 167, 168, 168, 168, 168, 168, 168, 168, 168, 168, 184, 184, 184, 184, 
            508, 509, 45, 45, 45, 45, 45, 45, 45, 45, 45, 45, 45, 45, 45, 45, 45, 45, 233, 168, 168, 168, 168, 168, 168, 168, 168, 168, 184, 184, 184, 184, 
            444, 445, 45, 45, 45, 45, 418, 419, 45, 45, 418, 419, 45, 45, 45, 45, 45, 45, 167, 168, 168, 168, 168, 168, 168, 168, 168, 168, 184, 184, 184, 184, 
            508, 509, 45, 45, 45, 45, 482, 483, 45, 45, 482, 483, 45, 45, 45, 45, 45, 45, 233, 168, 168, 168, 168, 168, 168, 168, 168, 168, 184, 184, 184, 184, 
            444, 445, 45, 45, 45, 45, 45, 45, 45, 45, 45, 45, 45, 45, 45, 45, 45, 45, 167, 168, 168, 168, 168, 168, 168, 168, 168, 168, 184, 184, 184, 184, 
            508, 509, 45, 45, 45, 45, 45, 45, 45, 45, 45, 45, 45, 45, 45, 45, 45, 45, 233, 168, 168, 168, 168, 168, 168, 168, 168, 168, 184, 184, 184, 184, 
            444, 445, 45, 45, 45, 45, 418, 419, 45, 45, 418, 419, 45, 45, 45, 45, 45, 45, 167, 168, 168, 168, 168, 168, 168, 168, 168, 168, 184, 184, 184, 184, 
            508, 509, 45, 45, 45, 45, 482, 483, 45, 45, 482, 483, 45, 45, 45, 45, 45, 45, 233, 168, 168, 168, 168, 168, 168, 168, 168, 168, 184, 184, 184, 184, 
            444, 445, 45, 45, 45, 45, 45, 45, 45, 45, 45, 45, 45, 45, 45, 45, 45, 45, 167, 168, 168, 168, 168, 168, 168, 168, 168, 168, 184, 184, 184, 184, 
            508, 509, 45, 45, 45, 45, 45, 45, 45, 45, 45, 45, 45, 45, 45, 45, 45, 45, 233, 168, 168, 168, 168, 168, 168, 168, 168, 168, 184, 184, 184, 184, 
            444, 445, 440, 441, 45, 45, 45, 45, 45, 45, 45, 45, 45, 45, 45, 45, 45, 45, 167, 168, 168, 168, 168, 168, 168, 168, 168, 168, 184, 184, 184, 184, 
            508, 509, 504, 505, 45, 45, 45, 45, 45, 45, 45, 45, 45, 45, 45, 45, 45, 45, 233, 168, 168, 168, 168, 168, 168, 168, 168, 168, 184, 184, 184, 184, 
            444, 445, 444, 445, 439, 440, 439, 440, 439, 440, 439, 440, 439, 440, 45, 45, 45, 45, 183, 184, 184, 184, 184, 184, 184, 184, 184, 184, 184, 184, 184, 184, 
            508, 509, 508, 509, 503, 504, 503, 504, 503, 504, 503, 504, 503, 504, 45, 45, 45, 45, 249, 184, 184, 184, 184, 184, 184, 184, 184, 184, 184, 184, 184, 184, 
            444, 445, 444, 445, 444, 445, 444, 445, 444, 445, 444, 445, 444, 445, 45, 45, 45, 45, 183, 184, 184, 184, 184, 184, 184, 184, 184, 184, 184, 184, 184, 184, 
            508, 509, 508, 509, 508, 509, 508, 509, 508, 509, 508, 509, 508, 509, 45, 45, 45, 45, 249, 184, 184, 184, 184, 184, 184, 184, 184, 184, 184, 184, 184, 184, 
        ]
    }
}