{
    "tilemap": {
        "W": 32,
        "H": 22,
        "tilemap": [
            444, 445, 444, 445, 444, 445, 444, 445, 444, 445, 444, 445, 444, 445, 58, 122, 444, 445, 444, 445, 444, 445, 444, 445, 444, 445, 444, 445, 444, 445, 444, 445, 
            508, 509, 508, 509, 508, 509, 508, 509, 508, 509, 508, 509, 508, 509, 58, 122, 508, 509, 508, 509, 508, 509, 508, 509, 508, 509, 508, 509, 508, 509, 508, 509, 
            444, 445, 444, 445, 444, 445, 444, 445, 444, 445, 444, 445, 444, 445, 58, 122, 444, 445, 444, 445, 444, 445, 444, 445, 444, 445, 444, 445, 444, 445, 444, 445, 
            508, 509, 508, 509, 508, 509, 508, 509, 508, 509, 508, 509, 508, 509, 58, 122, 508, 509, 508, 509, 508, 509, 508, 509, 508, 509, 508, 509, 508, 509, 508, 509, 
            045, 45, 45, 45, 45, 45, 45, 45, 45, 45, 45, 45, 45, 45, 45, 45, 45, 45, 45, 45, 45, 45, 45, 45, 45, 45, 45, 45, 442, 443, 444, 445, 
            045, 45, 45, 45, 45, 45, 45, 45, 45, 45, 45, 45, 45, 45, 45, 45, 45, 45, 45, 45, 45, 45, 45, 45, 45, 45, 45, 45, 506, 507, 508, 509, 
            309, 45, 45, 45, 45, 45, 312, 313, 309, 45, 45, 45, 45, 45, 45, 45, 45, 45, 45, 45, 45, 45, 45, 45, 436, 437, 45, 45, 45, 45, 444, 445, 
            373, 45, 45, 45, 45, 45, 376, 377, 373, 45, 45, 45, 45, 45, 45, 45, 45, 45, 45, 45, 45, 45, 45, 45, 500, 501, 45, 45, 45, 45, 508, 509, 
            316, 317, 45, 45, 45, 45, 45, 311, 316, 317, 45, 45, 45, 45, 45, 45, 45, 45, 45, 45, 436, 437, 45, 45, 45, 45, 45, 45, 45, 45, 444, 445, 
            380, 381, 45, 45, 45, 45, 45, 375, 380, 381, 45, 45, 45, 45, 45, 45, 45, 45, 45, 45, 500, 501, 45, 45, 45, 45, 45, 45, 45, 45, 508, 509, 
            045, 45, 45, 45, 45, 45, 45, 45, 45, 45, 45, 45, 45, 45, 45, 45, 436, 437, 45, 45, 45, 45, 45, 45, 436, 437, 45, 45, 45, 45, 444, 445, 
            045, 45, 45, 45, 45, 45, 45, 45, 45, 45, 45, 45, 45, 45, 45, 45, 500, 501, 45, 45, 45, 45, 45, 45, 500, 501, 45, 45, 45, 45, 508, 509, 
            045, 45, 45, 45, 312, 313, 309, 45, 45, 45, 45, 45, 45, 45, 45, 45, 45, 45, 45, 45, 436, 437, 45, 45, 45, 45, 45, 45, 45, 45, 444, 445, 
            045, 45, 45, 45, 376, 377, 373, 45, 45, 45, 45, 45, 45, 45, 45, 45, 45, 45, 45, 45, 500, 501, 45, 45, 45, 45, 45, 45, 45, 45, 508, 509, 
            045, 45, 45, 45, 45, 311, 316, 317, 45, 45, 45, 45, 45, 45, 45, 45, 45, 45, 45, 45, 45, 45, 45, 45, 436, 437, 45, 45, 45, 45, 444, 445, 
            045, 45, 45, 45, 45, 375, 380, 381, 45, 45, 45, 45, 45, 45, 45, 45, 45, 45, 45, 45, 45, 45, 45, 45, 500, 501, 45, 45, 45, 45, 508, 509, 
            045, 45, 45, 45, 45, 45, 45, 45, 45, 45, 45, 45, 45, 45, 45, 45, 45, 45, 45, 45, 45, 45, 45, 45, 45, 45, 45, 45, 438, 439, 444, 445, 
            045, 45, 45, 45, 45, 45, 45, 45, 45, 45, 45, 45, 45, 45, 45, 45, 45, 45, 45, 45, 45, 45, 45, 45, 45, 45, 45, 45, 502, 503, 508, 509, 
            439, 440, 439, 440, 439, 440, 439, 440, 439, 440, 439, 440, 439, 440, 439, 440, 439, 440, 439, 440, 439, 440, 439, 440, 439, 440, 439, 440, 444, 445, 444, 445, 
            503, 504, 503, 504, 503, 504, 503, 504, 503, 504, 503, 504, 503, 504, 503, 504, 503, 504, 503, 504, 503, 504, 503, 504, 503, 504, 503, 504, 508, 509, 508, 509, 
            444, 445, 444, 445, 444, 445, 444, 445, 444, 445, 444, 445, 444, 445, 444, 445, 444, 445, 444, 445, 444, 445, 444, 445, 444, 445, 444, 445, 444, 445, 444, 445, 
            508, 509, 508, 509, 508, 509, 508, 509, 508, 509, 508, 509, 508, 509, 508, 509, 508, 509, 508, 509, 508, 509, 508, 509, 508, 509, 508, 509, 508, 509, 508, 509, 
        ]
    }
}