{
    "tilemap": {
        "W": 32,
        "H": 22,
        "tilemap": [
            184, 184, 444, 445, 444, 445, 444, 445, 444, 445, 444, 445, 444, 445, 444, 445, 444, 445, 444, 445, 444, 445, 444, 445, 444, 445, 444, 445, 444, 445, 184, 184, 
            184, 184, 508, 509, 508, 509, 508, 509, 508, 509, 508, 509, 508, 509, 508, 509, 508, 509, 508, 509, 508, 509, 508, 509, 508, 509, 508, 509, 508, 509, 184, 184, 
            184, 184, 444, 445, 444, 445, 444, 445, 444, 445, 444, 445, 444, 445, 444, 445, 444, 445, 444, 445, 444, 445, 444, 445, 444, 445, 444, 445, 444, 445, 184, 184, 
            184, 184, 508, 509, 508, 509, 508, 509, 508, 509, 508, 509, 508, 509, 508, 509, 508, 509, 508, 509, 508, 509, 508, 509, 508, 509, 508, 509, 508, 509, 184, 184, 
            184, 184, 444, 445, 45, 45, 45, 45, 45, 45, 45, 45, 45, 45, 45, 45, 45, 45, 45, 45, 45, 45, 45, 45, 45, 45, 45, 45, 444, 445, 184, 184, 
            184, 184, 508, 509, 45, 45, 45, 45, 45, 45, 45, 45, 45, 45, 45, 45, 45, 45, 45, 45, 45, 45, 45, 45, 45, 45, 45, 45, 508, 509, 184, 184, 
            184, 184, 444, 445, 45, 45, 45, 45, 45, 191, 189, 45, 45, 45, 45, 191, 560, 561, 189, 45, 45, 45, 45, 191, 189, 45, 45, 45, 444, 445, 184, 184, 
            184, 184, 508, 509, 45, 45, 45, 45, 254, 255, 253, 254, 45, 45, 254, 255, 624, 625, 253, 254, 45, 45, 254, 255, 253, 254, 45, 45, 508, 509, 184, 184, 
            184, 184, 444, 445, 45, 45, 45, 45, 305, 306, 304, 305, 45, 45, 305, 306, 00, 00, 304, 305, 45, 45, 305, 306, 304, 305, 45, 45, 444, 445, 184, 184, 
            184, 184, 508, 509, 45, 45, 45, 45, 369, 370, 368, 369, 45, 45, 369, 370, 00, 00, 368, 369, 45, 45, 369, 370, 368, 369, 45, 45, 508, 509, 184, 184, 
            184, 184, 444, 445, 45, 45, 45, 45, 45, 45, 45, 45, 45, 45, 45, 45, 45, 45, 45, 45, 45, 45, 45, 45, 45, 45, 45, 45, 444, 445, 184, 184, 
            184, 184, 508, 509, 45, 45, 45, 45, 45, 45, 45, 45, 45, 45, 45, 45, 45, 45, 45, 45, 45, 45, 45, 45, 45, 45, 45, 45, 508, 509, 184, 184, 
            184, 184, 444, 445, 45, 45, 45, 45, 45, 45, 45, 45, 45, 45, 45, 45, 45, 45, 45, 45, 45, 45, 45, 45, 45, 45, 45, 45, 444, 445, 184, 184, 
            184, 184, 508, 509, 45, 45, 45, 45, 45, 45, 45, 45, 45, 45, 45, 45, 45, 45, 45, 45, 45, 45, 45, 45, 45, 45, 45, 45, 508, 509, 184, 184, 
            184, 184, 444, 445, 45, 45, 45, 45, 45, 45, 45, 45, 45, 45, 45, 45, 45, 45, 45, 45, 45, 45, 45, 45, 45, 45, 45, 45, 444, 445, 184, 184, 
            184, 184, 508, 509, 45, 45, 45, 45, 45, 45, 45, 45, 45, 45, 45, 45, 45, 45, 45, 45, 45, 45, 45, 45, 45, 45, 45, 45, 508, 509, 184, 184, 
            184, 184, 444, 445, 45, 45, 45, 45, 45, 45, 45, 45, 45, 45, 45, 45, 45, 45, 45, 45, 45, 45, 45, 45, 45, 45, 45, 45, 444, 445, 184, 184, 
            184, 184, 508, 509, 45, 45, 45, 45, 45, 45, 45, 45, 45, 45, 45, 45, 45, 45, 45, 45, 45, 45, 45, 45, 45, 45, 45, 45, 508, 509, 184, 184, 
            184, 184, 444, 445, 439, 440, 439, 440, 439, 440, 439, 440, 439, 440, 439, 440, 58, 122, 439, 440, 439, 440, 439, 440, 439, 440, 439, 440, 444, 445, 184, 184, 
            184, 184, 508, 509, 503, 504, 503, 504, 503, 504, 503, 504, 503, 504, 503, 504, 58, 122, 503, 504, 503, 504, 503, 504, 503, 504, 503, 504, 508, 509, 184, 184, 
            184, 184, 444, 445, 444, 445, 444, 445, 444, 445, 444, 445, 444, 445, 444, 445, 58, 122, 444, 445, 444, 445, 444, 445, 444, 445, 444, 445, 444, 445, 184, 184, 
            184, 184, 508, 509, 508, 509, 508, 509, 508, 509, 508, 509, 508, 509, 508, 509, 58, 122, 508, 509, 508, 509, 508, 509, 508, 509, 508, 509, 508, 509, 184, 184, 
        ]
    }
}