{
    "tilemap": {
        "W": 32,
        "H": 22,
        "tilemap": [
            428, 429, 428, 429, 428, 429, 45, 45, 45, 45, 428, 429, 428, 429, 428, 429, 428, 429, 45, 45, 45, 45, 428, 429, 428, 429, 45, 45, 428, 429, 428, 429, 
            492, 493, 492, 493, 492, 493, 45, 45, 45, 45, 492, 493, 492, 493, 492, 493, 492, 493, 45, 45, 45, 45, 492, 493, 492, 493, 45, 45, 492, 493, 492, 493, 
            428, 429, 428, 429, 428, 429, 45, 45, 45, 45, 426, 427, 428, 429, 00, 00, 430, 431, 45, 45, 45, 45, 426, 427, 430, 431, 45, 45, 426, 427, 428, 429, 
            492, 493, 492, 493, 492, 493, 45, 45, 45, 45, 490, 491, 492, 493, 00, 00, 494, 495, 45, 45, 45, 45, 490, 491, 494, 495, 45, 45, 490, 491, 492, 493, 
            428, 429, 428, 429, 430, 431, 45, 45, 45, 45, 45, 45, 45, 45, 45, 45, 45, 45, 45, 45, 45, 45, 45, 45, 45, 45, 45, 45, 45, 45, 45, 45, 
            492, 493, 492, 493, 494, 495, 45, 45, 45, 45, 45, 45, 45, 45, 45, 45, 45, 45, 45, 45, 45, 45, 45, 45, 45, 45, 45, 45, 45, 45, 45, 45, 
            426, 427, 430, 431, 45, 45, 45, 45, 45, 45, 45, 45, 45, 45, 45, 45, 45, 45, 45, 45, 45, 45, 45, 45, 45, 45, 45, 45, 45, 45, 45, 45, 
            490, 491, 494, 495, 45, 45, 45, 45, 45, 45, 45, 45, 45, 45, 45, 45, 45, 45, 45, 45, 45, 45, 45, 45, 45, 45, 45, 45, 45, 45, 45, 45, 
            045, 45, 45, 45, 45, 45, 45, 45, 45, 45, 45, 45, 418, 419, 45, 45, 45, 45, 45, 45, 45, 45, 45, 45, 45, 45, 45, 45, 45, 45, 45, 45, 
            045, 45, 45, 45, 45, 45, 45, 45, 45, 45, 45, 45, 482, 483, 45, 45, 45, 45, 45, 45, 45, 45, 45, 45, 45, 45, 45, 45, 45, 45, 45, 45, 
            045, 45, 45, 45, 45, 45, 45, 45, 45, 45, 45, 45, 45, 45, 45, 45, 45, 45, 45, 45, 45, 45, 45, 45, 45, 45, 45, 45, 45, 45, 45, 45, 
            045, 45, 45, 45, 45, 45, 45, 45, 45, 45, 45, 45, 45, 45, 45, 45, 45, 45, 45, 45, 45, 45, 45, 45, 45, 45, 45, 45, 45, 45, 45, 45, 
            045, 45, 45, 45, 45, 45, 45, 45, 45, 45, 45, 45, 418, 419, 45, 45, 45, 45, 45, 45, 45, 45, 45, 45, 45, 45, 45, 45, 45, 45, 45, 45, 
            045, 45, 45, 45, 45, 45, 45, 45, 45, 45, 45, 45, 482, 483, 45, 45, 45, 45, 45, 45, 45, 45, 45, 45, 45, 45, 45, 45, 45, 45, 45, 45, 
            422, 423, 424, 425, 45, 45, 45, 45, 45, 45, 45, 45, 45, 45, 45, 45, 45, 45, 45, 45, 45, 45, 45, 45, 45, 45, 45, 45, 45, 45, 45, 45, 
            486, 487, 488, 489, 45, 45, 45, 45, 45, 45, 45, 45, 45, 45, 45, 45, 45, 45, 45, 45, 45, 45, 45, 45, 45, 45, 45, 45, 45, 45, 45, 45, 
            428, 429, 428, 429, 424, 425, 45, 45, 45, 45, 45, 45, 45, 45, 45, 45, 45, 45, 45, 45, 45, 45, 45, 45, 45, 45, 45, 45, 45, 45, 45, 45, 
            492, 493, 492, 493, 488, 489, 45, 45, 45, 45, 45, 45, 45, 45, 45, 45, 45, 45, 45, 45, 45, 45, 45, 45, 45, 45, 45, 45, 45, 45, 45, 45, 
            428, 429, 428, 429, 428, 429, 423, 424, 423, 424, 423, 424, 423, 424, 423, 424, 423, 424, 423, 424, 423, 424, 423, 424, 423, 424, 423, 424, 423, 424, 423, 424, 
            492, 493, 492, 493, 492, 493, 487, 488, 487, 488, 487, 488, 487, 488, 487, 488, 487, 488, 487, 488, 487, 488, 487, 488, 487, 488, 487, 488, 487, 488, 487, 488, 
            428, 429, 428, 429, 428, 429, 428, 429, 428, 429, 428, 429, 428, 429, 428, 429, 428, 429, 428, 429, 428, 429, 428, 429, 428, 429, 428, 429, 428, 429, 428, 429, 
            492, 493, 492, 493, 492, 493, 492, 493, 492, 493, 492, 493, 492, 493, 492, 493, 492, 493, 492, 493, 492, 493, 492, 493, 492, 493, 492, 493, 492, 493, 492, 493, 
        ]
    }
}