{
    "tilemap": {
        "W": 32,
        "H": 22,
        "tilemap": [
            434, 435, 434, 435, 434, 435, 434, 435, 434, 435, 434, 435, 434, 435, 434, 435, 434, 435, 434, 435, 434, 435, 434, 435, 434, 435, 434, 435, 434, 435, 434, 435, 
            498, 499, 498, 499, 498, 499, 498, 499, 498, 499, 498, 499, 498, 499, 498, 499, 498, 499, 498, 499, 498, 499, 498, 499, 498, 499, 498, 499, 498, 499, 498, 499, 
            434, 435, 434, 435, 434, 435, 434, 435, 434, 435, 434, 435, 434, 435, 434, 435, 434, 435, 434, 435, 434, 435, 434, 435, 434, 435, 434, 435, 434, 435, 434, 435, 
            498, 499, 498, 499, 498, 499, 498, 499, 498, 499, 498, 499, 498, 499, 498, 499, 498, 499, 498, 499, 498, 499, 498, 499, 498, 499, 498, 499, 498, 499, 498, 499, 
            045, 45, 45, 45, 45, 45, 45, 45, 45, 45, 45, 45, 45, 45, 45, 45, 45, 45, 45, 45, 45, 45, 45, 45, 45, 45, 45, 45, 434, 435, 45, 45, 
            045, 45, 45, 45, 45, 45, 45, 45, 45, 45, 45, 45, 45, 45, 45, 45, 45, 45, 45, 45, 45, 45, 45, 45, 45, 45, 45, 45, 498, 499, 45, 45, 
            045, 45, 45, 45, 45, 45, 45, 45, 45, 45, 45, 45, 45, 45, 45, 45, 45, 45, 45, 45, 45, 45, 418, 419, 45, 45, 45, 45, 45, 45, 45, 45, 
            045, 45, 45, 45, 45, 45, 45, 45, 45, 45, 45, 45, 45, 45, 45, 45, 45, 45, 45, 45, 45, 45, 482, 483, 45, 45, 45, 45, 45, 45, 45, 45, 
            045, 45, 45, 45, 45, 45, 45, 45, 45, 45, 45, 45, 45, 45, 45, 45, 45, 45, 45, 45, 45, 45, 45, 45, 45, 45, 418, 419, 45, 45, 45, 45, 
            045, 45, 45, 45, 45, 45, 45, 45, 45, 45, 45, 45, 45, 45, 45, 45, 45, 45, 45, 45, 45, 45, 45, 45, 45, 45, 482, 483, 45, 45, 45, 45, 
            045, 45, 45, 45, 45, 45, 45, 45, 45, 45, 45, 45, 45, 45, 45, 45, 45, 45, 45, 45, 45, 45, 418, 419, 45, 45, 45, 45, 45, 45, 45, 45, 
            045, 45, 45, 45, 45, 45, 45, 45, 45, 45, 45, 45, 45, 45, 45, 45, 45, 45, 45, 45, 45, 45, 482, 483, 45, 45, 45, 45, 45, 45, 45, 45, 
            247, 247, 247, 247, 231, 231, 231, 231, 231, 231, 231, 231, 231, 232, 45, 45, 45, 45, 45, 45, 45, 45, 45, 45, 45, 45, 418, 419, 45, 45, 45, 45, 
            184, 184, 184, 184, 168, 168, 168, 168, 168, 168, 168, 168, 168, 169, 45, 45, 45, 45, 45, 45, 45, 45, 45, 45, 45, 45, 482, 483, 45, 45, 45, 45, 
            184, 184, 184, 184, 168, 168, 168, 168, 168, 168, 168, 168, 168, 169, 45, 45, 45, 45, 45, 45, 45, 45, 418, 419, 45, 45, 45, 45, 45, 45, 45, 45, 
            184, 184, 184, 184, 168, 168, 168, 168, 168, 168, 168, 168, 168, 235, 45, 45, 45, 45, 45, 45, 45, 45, 482, 483, 45, 45, 45, 45, 45, 45, 45, 45, 
            184, 184, 184, 184, 168, 168, 168, 168, 168, 168, 168, 168, 168, 169, 45, 45, 45, 45, 45, 45, 45, 45, 45, 45, 45, 45, 45, 45, 434, 435, 45, 45, 
            184, 184, 184, 184, 168, 168, 168, 168, 168, 168, 168, 168, 168, 235, 45, 45, 45, 45, 45, 45, 45, 45, 45, 45, 45, 45, 45, 45, 498, 499, 45, 45, 
            184, 184, 184, 184, 184, 184, 184, 184, 184, 184, 184, 184, 184, 185, 45, 45, 45, 45, 434, 435, 434, 435, 434, 435, 434, 435, 434, 435, 434, 435, 434, 435, 
            184, 184, 184, 184, 184, 184, 184, 184, 184, 184, 184, 184, 184, 251, 45, 45, 45, 45, 498, 499, 498, 499, 498, 499, 498, 499, 498, 499, 498, 499, 498, 499, 
            184, 184, 184, 184, 184, 184, 184, 184, 184, 184, 184, 184, 184, 185, 45, 45, 45, 45, 434, 435, 434, 435, 434, 435, 434, 435, 434, 435, 434, 435, 434, 435, 
            184, 184, 184, 184, 184, 184, 184, 184, 184, 184, 184, 184, 184, 251, 45, 45, 45, 45, 498, 499, 498, 499, 498, 499, 498, 499, 498, 499, 498, 499, 498, 499, 
        ]
    }
}