{
    "tilemap": {
        "W": 32,
        "H": 22,
        "tilemap": [
            444, 445, 444, 445, 444, 445, 444, 445, 444, 445, 444, 445, 444, 445, 444, 445, 444, 445, 444, 445, 444, 445, 444, 445, 444, 445, 444, 445, 444, 445, 444, 445, 
            508, 509, 508, 509, 508, 509, 508, 509, 508, 509, 508, 509, 508, 509, 508, 509, 508, 509, 508, 509, 508, 509, 508, 509, 508, 509, 508, 509, 508, 509, 508, 509, 
            444, 445, 444, 445, 444, 445, 444, 445, 444, 445, 444, 445, 444, 445, 444, 445, 444, 445, 444, 445, 444, 445, 444, 445, 444, 445, 444, 445, 444, 445, 444, 445, 
            508, 509, 508, 509, 508, 509, 508, 509, 508, 509, 508, 509, 508, 509, 508, 509, 508, 509, 508, 509, 508, 509, 508, 509, 508, 509, 508, 509, 508, 509, 508, 509, 
            444, 445, 446, 447, 45, 45, 45, 45, 45, 45, 45, 45, 45, 45, 45, 45, 45, 45, 45, 45, 45, 45, 45, 45, 45, 45, 45, 45, 442, 443, 444, 445, 
            508, 509, 510, 495, 45, 45, 45, 45, 45, 45, 45, 45, 45, 45, 45, 45, 45, 45, 45, 45, 45, 45, 45, 45, 45, 45, 45, 45, 506, 507, 508, 509, 
            444, 445, 45, 45, 45, 45, 45, 45, 45, 45, 230, 231, 231, 231, 231, 231, 231, 231, 231, 231, 231, 232, 45, 45, 45, 45, 45, 45, 45, 45, 444, 445, 
            508, 509, 45, 45, 45, 45, 45, 45, 45, 45, 167, 168, 168, 168, 168, 168, 168, 168, 168, 168, 168, 169, 45, 45, 45, 45, 45, 45, 45, 45, 508, 509, 
            444, 445, 45, 45, 45, 45, 418, 419, 45, 45, 167, 168, 168, 168, 168, 168, 168, 168, 168, 168, 168, 169, 45, 45, 418, 419, 45, 45, 45, 45, 444, 445, 
            508, 509, 45, 45, 45, 45, 482, 483, 45, 45, 233, 168, 168, 168, 168, 168, 168, 168, 168, 168, 168, 235, 45, 45, 482, 483, 45, 45, 45, 45, 508, 509, 
            444, 445, 45, 45, 45, 45, 45, 45, 45, 45, 167, 168, 168, 168, 168, 168, 168, 168, 168, 168, 168, 169, 45, 45, 45, 45, 45, 45, 45, 45, 444, 445, 
            508, 509, 45, 45, 45, 45, 45, 45, 45, 45, 233, 168, 168, 168, 168, 168, 168, 168, 168, 168, 168, 235, 45, 45, 45, 45, 45, 45, 45, 45, 508, 509, 
            444, 445, 45, 45, 45, 45, 418, 419, 45, 45, 233, 168, 168, 168, 168, 168, 168, 168, 168, 168, 168, 235, 45, 45, 418, 419, 45, 45, 45, 45, 444, 445, 
            508, 509, 45, 45, 45, 45, 482, 483, 45, 45, 170, 164, 164, 164, 164, 164, 164, 164, 164, 164, 164, 172, 45, 45, 482, 483, 45, 45, 45, 45, 508, 509, 
            444, 445, 45, 45, 45, 45, 45, 45, 45, 45, 45, 45, 45, 45, 45, 45, 45, 45, 45, 45, 45, 45, 45, 45, 45, 45, 45, 45, 45, 45, 444, 445, 
            508, 509, 45, 45, 45, 45, 45, 45, 45, 45, 45, 45, 45, 45, 45, 45, 45, 45, 45, 45, 45, 45, 45, 45, 45, 45, 45, 45, 45, 45, 508, 509, 
            444, 445, 440, 441, 45, 45, 45, 45, 45, 45, 45, 45, 45, 45, 45, 45, 45, 45, 45, 45, 45, 45, 45, 45, 45, 45, 45, 45, 438, 439, 444, 445, 
            508, 509, 504, 505, 45, 45, 45, 45, 45, 45, 45, 45, 45, 45, 45, 45, 45, 45, 45, 45, 45, 45, 45, 45, 45, 45, 45, 45, 502, 503, 508, 509, 
            444, 445, 444, 445, 439, 440, 439, 440, 439, 440, 439, 440, 439, 440, 45, 45, 45, 45, 439, 440, 439, 440, 439, 440, 439, 440, 439, 440, 444, 445, 444, 445, 
            508, 509, 508, 509, 503, 504, 503, 504, 503, 504, 503, 504, 503, 504, 45, 45, 45, 45, 503, 504, 503, 504, 503, 504, 503, 504, 503, 504, 508, 509, 508, 509, 
            444, 445, 444, 445, 444, 445, 444, 445, 444, 445, 444, 445, 444, 445, 45, 45, 45, 45, 444, 445, 444, 445, 444, 445, 444, 445, 444, 445, 444, 445, 444, 445, 
            508, 509, 508, 509, 508, 509, 508, 509, 508, 509, 508, 509, 508, 509, 45, 45, 45, 45, 508, 509, 508, 509, 508, 509, 508, 509, 508, 509, 508, 509, 508, 509, 
        ]
    }
}