{
    "tilemap": {
        "W": 32,
        "H": 22,
        "tilemap": [
            444, 445, 444, 445, 444, 445, 444, 445, 444, 445, 444, 445, 444, 445, 444, 445, 444, 445, 444, 445, 444, 445, 444, 445, 444, 445, 444, 445, 444, 445, 444, 445, 
            508, 509, 508, 509, 508, 509, 508, 509, 508, 509, 508, 509, 508, 509, 508, 509, 508, 509, 508, 509, 508, 509, 508, 509, 508, 509, 508, 509, 508, 509, 508, 509, 
            444, 445, 444, 445, 444, 445, 444, 445, 444, 445, 444, 445, 444, 445, 444, 445, 444, 445, 444, 445, 444, 445, 444, 445, 444, 445, 444, 445, 444, 445, 444, 445, 
            508, 509, 508, 509, 508, 509, 508, 509, 508, 509, 508, 509, 508, 509, 508, 509, 508, 509, 508, 509, 508, 509, 508, 509, 508, 509, 508, 509, 508, 509, 508, 509, 
            444, 445, 446, 447, 45, 45, 45, 45, 45, 45, 45, 45, 45, 45, 45, 45, 45, 45, 45, 45, 45, 45, 45, 45, 45, 45, 45, 45, 444, 445, 444, 445, 
            508, 509, 510, 495, 45, 45, 45, 45, 45, 45, 45, 45, 45, 45, 45, 45, 45, 45, 45, 45, 45, 45, 45, 45, 45, 45, 45, 45, 508, 509, 508, 509, 
            444, 445, 45, 45, 45, 45, 45, 45, 45, 45, 45, 45, 45, 45, 45, 45, 45, 45, 45, 45, 45, 45, 45, 45, 45, 45, 45, 45, 442, 443, 444, 445, 
            508, 509, 45, 45, 45, 45, 45, 45, 45, 45, 45, 45, 45, 45, 45, 45, 45, 45, 45, 45, 45, 45, 45, 45, 45, 45, 45, 45, 506, 507, 508, 509, 
            444, 445, 45, 45, 432, 433, 45, 45, 432, 433, 45, 45, 432, 433, 45, 45, 45, 45, 45, 45, 45, 45, 45, 45, 45, 45, 45, 45, 45, 45, 444, 445, 
            508, 509, 45, 45, 496, 497, 45, 45, 496, 497, 45, 45, 496, 497, 45, 45, 45, 45, 45, 45, 45, 45, 45, 45, 45, 45, 45, 45, 45, 45, 508, 509, 
            444, 445, 45, 45, 45, 45, 45, 45, 45, 45, 45, 45, 45, 45, 45, 45, 45, 45, 45, 45, 45, 45, 45, 45, 45, 45, 45, 45, 45, 45, 444, 445, 
            508, 509, 45, 45, 45, 45, 45, 45, 45, 45, 45, 45, 45, 45, 45, 45, 45, 45, 45, 45, 45, 45, 45, 45, 45, 45, 45, 45, 45, 45, 508, 509, 
            444, 445, 45, 45, 432, 433, 45, 45, 432, 433, 45, 45, 432, 433, 45, 45, 45, 45, 246, 247, 247, 247, 247, 247, 247, 247, 247, 247, 247, 247, 184, 184, 
            508, 509, 45, 45, 496, 497, 45, 45, 496, 497, 45, 45, 496, 497, 45, 45, 45, 45, 183, 184, 184, 184, 184, 184, 184, 184, 184, 184, 184, 184, 184, 184, 
            444, 445, 45, 45, 45, 45, 45, 45, 45, 45, 45, 45, 45, 45, 45, 45, 45, 45, 183, 184, 184, 184, 184, 184, 184, 184, 184, 184, 184, 184, 184, 184, 
            508, 509, 45, 45, 45, 45, 45, 45, 45, 45, 45, 45, 45, 45, 45, 45, 45, 45, 249, 184, 184, 184, 184, 184, 184, 184, 184, 184, 184, 184, 184, 184, 
            444, 445, 440, 441, 45, 45, 45, 45, 45, 45, 45, 45, 45, 45, 45, 45, 45, 45, 183, 184, 184, 184, 184, 184, 184, 184, 184, 184, 184, 184, 184, 184, 
            508, 509, 504, 505, 45, 45, 45, 45, 45, 45, 45, 45, 45, 45, 45, 45, 45, 45, 249, 184, 184, 184, 184, 184, 184, 184, 184, 184, 184, 184, 184, 184, 
            444, 445, 444, 445, 439, 440, 439, 440, 439, 440, 439, 440, 439, 440, 439, 440, 45, 45, 183, 184, 184, 184, 184, 184, 184, 184, 184, 184, 184, 184, 184, 184, 
            508, 509, 508, 509, 503, 504, 503, 504, 503, 504, 503, 504, 503, 504, 503, 504, 45, 45, 249, 184, 184, 184, 184, 184, 184, 184, 184, 184, 184, 184, 184, 184, 
            444, 445, 444, 445, 444, 445, 444, 445, 444, 445, 444, 445, 444, 445, 444, 445, 45, 45, 183, 184, 184, 184, 184, 184, 184, 184, 184, 184, 184, 184, 184, 184, 
            508, 509, 508, 509, 508, 509, 508, 509, 508, 509, 508, 509, 508, 509, 508, 509, 45, 45, 249, 184, 184, 184, 184, 184, 184, 184, 184, 184, 184, 184, 184, 184, 
        ]
    }
}