{
    "tilemap": {
        "W": 32,
        "H": 22,
        "tilemap": [
            396, 397, 396, 397, 396, 397, 396, 397, 396, 397, 396, 397, 396, 397, 396, 397, 396, 397, 396, 397, 396, 397, 396, 397, 396, 397, 396, 397, 10, 74, 396, 397, 
            460, 461, 460, 461, 460, 461, 460, 461, 460, 461, 460, 461, 460, 461, 460, 461, 460, 461, 460, 461, 460, 461, 460, 461, 460, 461, 460, 461, 10, 74, 460, 461, 
            396, 397, 396, 397, 396, 397, 396, 397, 396, 397, 396, 397, 396, 397, 396, 397, 396, 397, 396, 397, 396, 397, 396, 397, 396, 397, 396, 397, 10, 74, 396, 397, 
            460, 461, 460, 461, 460, 461, 460, 461, 460, 461, 460, 461, 460, 461, 460, 461, 460, 461, 460, 461, 460, 461, 460, 461, 460, 461, 460, 461, 10, 74, 460, 461, 
            396, 397, 396, 397, 396, 397, 396, 397, 396, 397, 396, 397, 396, 397, 396, 397, 396, 397, 396, 397, 396, 397, 396, 397, 396, 397, 396, 397, 10, 74, 396, 397, 
            460, 461, 460, 461, 460, 461, 460, 461, 460, 461, 460, 461, 460, 461, 460, 461, 460, 461, 460, 461, 460, 461, 460, 461, 460, 461, 460, 461, 10, 74, 460, 461, 
            396, 397, 396, 397, 396, 397, 396, 397, 396, 397, 396, 397, 396, 397, 396, 397, 396, 397, 396, 397, 396, 397, 396, 397, 396, 397, 396, 397, 10, 74, 396, 397, 
            460, 461, 460, 461, 460, 461, 460, 461, 460, 461, 460, 461, 460, 461, 460, 461, 460, 461, 460, 461, 460, 461, 460, 461, 460, 461, 460, 461, 10, 74, 460, 461, 
            396, 397, 396, 397, 396, 397, 396, 397, 396, 397, 396, 397, 396, 397, 396, 397, 396, 397, 396, 397, 396, 397, 396, 397, 396, 397, 396, 397, 10, 74, 396, 397, 
            460, 461, 460, 461, 460, 461, 460, 461, 460, 461, 460, 461, 460, 461, 460, 461, 460, 461, 460, 461, 460, 461, 460, 461, 460, 461, 460, 461, 10, 74, 460, 461, 
            396, 397, 396, 397, 13, 13, 13, 13, 13, 13, 13, 13, 13, 13, 13, 13, 13, 13, 13, 13, 13, 13, 13, 13, 13, 13, 13, 13, 13, 13, 396, 397, 
            460, 461, 460, 461, 13, 13, 13, 13, 13, 13, 13, 13, 13, 13, 13, 13, 13, 13, 13, 13, 13, 13, 13, 13, 13, 13, 13, 13, 13, 13, 460, 461, 
            396, 397, 396, 397, 13, 13, 13, 13, 13, 13, 13, 13, 13, 13, 13, 13, 13, 13, 13, 13, 13, 13, 13, 13, 13, 13, 13, 13, 13, 13, 396, 397, 
            460, 461, 460, 461, 13, 13, 13, 13, 13, 13, 13, 13, 13, 13, 13, 13, 13, 13, 13, 13, 13, 13, 13, 13, 13, 13, 13, 13, 13, 13, 460, 461, 
            396, 397, 396, 397, 13, 13, 13, 13, 13, 13, 13, 13, 13, 13, 13, 13, 13, 13, 13, 13, 13, 13, 13, 13, 13, 13, 13, 13, 13, 13, 396, 397, 
            460, 461, 460, 461, 13, 13, 13, 13, 13, 13, 13, 13, 13, 13, 13, 13, 13, 13, 13, 13, 13, 13, 13, 13, 13, 13, 13, 13, 13, 13, 460, 461, 
            396, 397, 396, 397, 13, 13, 13, 13, 13, 13, 13, 13, 13, 13, 13, 13, 13, 13, 13, 13, 13, 13, 13, 13, 13, 13, 13, 13, 13, 13, 396, 397, 
            460, 461, 460, 461, 13, 13, 13, 13, 13, 13, 13, 13, 13, 13, 13, 13, 13, 13, 13, 13, 13, 13, 13, 13, 13, 13, 13, 13, 13, 13, 460, 461, 
            396, 397, 396, 397, 13, 13, 13, 13, 13, 13, 13, 13, 13, 13, 13, 13, 13, 13, 13, 13, 13, 13, 13, 13, 13, 13, 13, 13, 391, 392, 396, 397, 
            460, 461, 460, 461, 13, 13, 13, 13, 13, 13, 13, 13, 13, 13, 13, 13, 13, 13, 13, 13, 13, 13, 13, 13, 13, 13, 13, 13, 455, 456, 460, 461, 
            396, 397, 396, 397, 13, 13, 13, 13, 13, 13, 13, 13, 13, 13, 13, 13, 13, 13, 13, 13, 13, 13, 13, 13, 13, 13, 13, 13, 396, 397, 396, 397, 
            460, 461, 460, 461, 13, 13, 13, 13, 13, 13, 13, 13, 13, 13, 13, 13, 13, 13, 13, 13, 13, 13, 13, 13, 13, 13, 13, 13, 460, 461, 460, 461, 
        ]
    }
}