{
    "tilemap": {
        "W": 32,
        "H": 22,
        "tilemap": [
            444, 445, 444, 445, 444, 445, 58, 122, 444, 445, 444, 445, 444, 445, 444, 445, 444, 445, 444, 445, 444, 445, 444, 445, 444, 445, 58, 122, 444, 445, 444, 445, 
            508, 509, 508, 509, 508, 509, 58, 122, 508, 509, 508, 509, 508, 509, 508, 509, 508, 509, 508, 509, 508, 509, 508, 509, 508, 509, 58, 122, 508, 509, 508, 509, 
            444, 445, 444, 445, 444, 445, 58, 122, 444, 445, 444, 445, 446, 447, 442, 443, 444, 445, 444, 445, 00, 00, 444, 445, 444, 445, 58, 122, 444, 445, 444, 445, 
            508, 509, 508, 509, 508, 509, 58, 122, 508, 509, 508, 509, 510, 495, 506, 507, 508, 509, 508, 509, 00, 00, 508, 509, 508, 509, 58, 122, 508, 509, 508, 509, 
            045, 45, 45, 45, 45, 45, 45, 45, 45, 45, 45, 45, 45, 45, 45, 45, 45, 45, 45, 45, 45, 45, 45, 45, 45, 45, 45, 45, 442, 443, 444, 445, 
            045, 45, 45, 45, 45, 45, 45, 45, 45, 45, 45, 45, 45, 45, 45, 45, 45, 45, 45, 45, 45, 45, 45, 45, 45, 45, 45, 45, 506, 507, 508, 509, 
            045, 45, 45, 45, 45, 45, 45, 45, 45, 45, 45, 45, 45, 45, 45, 45, 45, 45, 45, 45, 45, 45, 45, 45, 45, 45, 45, 45, 45, 45, 444, 445, 
            045, 45, 45, 45, 45, 45, 45, 45, 45, 45, 45, 45, 45, 45, 45, 45, 45, 45, 45, 45, 45, 45, 45, 45, 45, 45, 45, 45, 45, 45, 508, 509, 
            045, 45, 45, 45, 432, 433, 45, 45, 45, 45, 432, 433, 45, 45, 45, 45, 432, 433, 45, 45, 45, 45, 432, 433, 45, 45, 45, 45, 45, 45, 444, 445, 
            045, 45, 45, 45, 496, 497, 45, 45, 45, 45, 496, 497, 45, 45, 45, 45, 496, 497, 45, 45, 45, 45, 496, 497, 45, 45, 45, 45, 45, 45, 508, 509, 
            045, 45, 45, 45, 45, 45, 45, 45, 45, 45, 45, 45, 45, 45, 45, 45, 45, 45, 45, 45, 45, 45, 45, 45, 45, 45, 45, 45, 45, 45, 444, 445, 
            045, 45, 45, 45, 45, 45, 45, 45, 45, 45, 45, 45, 45, 45, 45, 45, 45, 45, 45, 45, 45, 45, 45, 45, 45, 45, 45, 45, 45, 45, 508, 509, 
            045, 45, 45, 45, 432, 433, 45, 45, 45, 45, 432, 433, 45, 45, 45, 45, 432, 433, 45, 45, 45, 45, 432, 433, 45, 45, 45, 45, 45, 45, 444, 445, 
            045, 45, 45, 45, 496, 497, 45, 45, 45, 45, 496, 497, 45, 45, 45, 45, 496, 497, 45, 45, 45, 45, 496, 497, 45, 45, 45, 45, 45, 45, 508, 509, 
            045, 45, 45, 45, 45, 45, 45, 45, 45, 45, 45, 45, 45, 45, 45, 45, 45, 45, 45, 45, 45, 45, 45, 45, 45, 45, 45, 45, 45, 45, 444, 445, 
            045, 45, 45, 45, 45, 45, 45, 45, 45, 45, 45, 45, 45, 45, 45, 45, 45, 45, 45, 45, 45, 45, 45, 45, 45, 45, 45, 45, 45, 45, 508, 509, 
            045, 45, 45, 45, 45, 45, 45, 45, 45, 45, 45, 45, 45, 45, 45, 45, 45, 45, 45, 45, 45, 45, 45, 45, 45, 45, 45, 45, 438, 439, 444, 445, 
            045, 45, 45, 45, 45, 45, 45, 45, 45, 45, 45, 45, 45, 45, 45, 45, 45, 45, 45, 45, 45, 45, 45, 45, 45, 45, 45, 45, 502, 503, 508, 509, 
            439, 440, 439, 440, 439, 440, 439, 440, 58, 122, 439, 440, 440, 441, 438, 439, 439, 440, 439, 440, 439, 440, 439, 440, 439, 440, 439, 440, 444, 445, 444, 445, 
            503, 504, 503, 504, 503, 504, 503, 504, 58, 122, 503, 504, 504, 505, 502, 503, 503, 504, 503, 504, 503, 504, 503, 504, 503, 504, 503, 504, 508, 509, 508, 509, 
            444, 445, 444, 445, 444, 445, 444, 445, 58, 122, 444, 445, 444, 445, 444, 445, 444, 445, 444, 445, 444, 445, 444, 445, 444, 445, 444, 445, 444, 445, 444, 445, 
            508, 509, 508, 509, 508, 509, 508, 509, 58, 122, 508, 509, 508, 509, 508, 509, 508, 509, 508, 509, 508, 509, 508, 509, 508, 509, 508, 509, 508, 509, 508, 509, 
        ]
    }
}