{
    "tilemap": {
        "W": 32,
        "H": 22,
        "tilemap": [
            428, 429, 428, 429, 428, 429, 428, 429, 428, 429, 428, 429, 428, 429, 428, 429, 428, 429, 428, 429, 428, 429, 428, 429, 45, 45, 45, 45, 428, 429, 428, 429, 
            492, 493, 492, 493, 492, 493, 492, 493, 492, 493, 492, 493, 492, 493, 492, 493, 492, 493, 492, 493, 492, 493, 492, 493, 45, 45, 45, 45, 492, 493, 492, 493, 
            428, 429, 428, 429, 428, 429, 428, 429, 428, 429, 428, 429, 428, 429, 428, 429, 428, 429, 428, 429, 428, 429, 430, 431, 45, 45, 45, 45, 428, 429, 428, 429, 
            492, 493, 492, 493, 492, 493, 492, 493, 492, 493, 492, 493, 492, 493, 492, 493, 492, 493, 492, 493, 492, 493, 494, 495, 45, 45, 45, 45, 492, 493, 492, 493, 
            045, 45, 45, 45, 45, 45, 45, 45, 45, 45, 45, 45, 45, 45, 45, 45, 45, 45, 45, 45, 45, 45, 45, 45, 45, 45, 45, 45, 428, 429, 428, 429, 
            045, 45, 45, 45, 45, 45, 45, 45, 45, 45, 45, 45, 45, 45, 45, 45, 45, 45, 45, 45, 45, 45, 45, 45, 45, 45, 45, 45, 492, 493, 492, 493, 
            045, 45, 45, 45, 45, 45, 45, 45, 45, 45, 45, 45, 45, 45, 45, 45, 420, 421, 45, 45, 45, 45, 45, 45, 45, 45, 45, 45, 426, 427, 428, 429, 
            045, 45, 45, 45, 45, 45, 45, 45, 45, 45, 45, 45, 45, 45, 45, 45, 484, 485, 45, 45, 45, 45, 45, 45, 45, 45, 45, 45, 490, 491, 492, 493, 
            045, 45, 45, 45, 45, 45, 45, 45, 45, 45, 45, 45, 45, 45, 45, 45, 45, 45, 45, 45, 420, 421, 45, 45, 45, 45, 45, 45, 45, 45, 426, 427, 
            045, 45, 45, 45, 45, 45, 45, 45, 45, 45, 45, 45, 45, 45, 45, 45, 45, 45, 45, 45, 484, 485, 45, 45, 45, 45, 45, 45, 45, 45, 490, 491, 
            045, 45, 45, 45, 420, 421, 45, 45, 45, 45, 420, 421, 45, 45, 45, 45, 420, 421, 45, 45, 45, 45, 45, 45, 45, 45, 45, 45, 45, 45, 45, 45, 
            045, 45, 45, 45, 484, 485, 45, 45, 45, 45, 484, 485, 45, 45, 45, 45, 484, 485, 45, 45, 45, 45, 45, 45, 45, 45, 45, 45, 45, 45, 45, 45, 
            045, 45, 45, 45, 45, 45, 45, 45, 45, 45, 45, 45, 45, 45, 45, 45, 45, 45, 45, 45, 420, 421, 45, 45, 45, 45, 45, 45, 45, 45, 422, 423, 
            045, 45, 45, 45, 45, 45, 45, 45, 45, 45, 45, 45, 45, 45, 45, 45, 45, 45, 45, 45, 484, 485, 45, 45, 45, 45, 45, 45, 45, 45, 486, 487, 
            045, 45, 45, 45, 45, 45, 45, 45, 45, 45, 45, 45, 45, 45, 45, 45, 420, 421, 45, 45, 45, 45, 45, 45, 45, 45, 45, 45, 422, 423, 428, 429, 
            045, 45, 45, 45, 45, 45, 45, 45, 45, 45, 45, 45, 45, 45, 45, 45, 484, 485, 45, 45, 45, 45, 45, 45, 45, 45, 45, 45, 486, 487, 492, 493, 
            045, 45, 45, 45, 45, 45, 45, 45, 45, 45, 45, 45, 45, 45, 45, 45, 45, 45, 45, 45, 45, 45, 45, 45, 45, 45, 45, 45, 428, 429, 428, 429, 
            045, 45, 45, 45, 45, 45, 45, 45, 45, 45, 45, 45, 45, 45, 45, 45, 45, 45, 45, 45, 45, 45, 45, 45, 45, 45, 45, 45, 492, 493, 492, 493, 
            423, 424, 423, 424, 423, 424, 423, 424, 423, 424, 423, 424, 423, 424, 423, 424, 423, 424, 423, 424, 423, 424, 423, 424, 423, 424, 423, 424, 428, 429, 428, 429, 
            487, 488, 487, 488, 487, 488, 487, 488, 487, 488, 487, 488, 487, 488, 487, 488, 487, 488, 487, 488, 487, 488, 487, 488, 487, 488, 487, 488, 492, 493, 492, 493, 
            428, 429, 428, 429, 428, 429, 428, 429, 428, 429, 428, 429, 428, 429, 428, 429, 428, 429, 428, 429, 428, 429, 428, 429, 428, 429, 428, 429, 428, 429, 428, 429, 
            492, 493, 492, 493, 492, 493, 492, 493, 492, 493, 492, 493, 492, 493, 492, 493, 492, 493, 492, 493, 492, 493, 492, 493, 492, 493, 492, 493, 492, 493, 492, 493, 
        ]
    }
}