{
    "tilemap": {
        "W": 32,
        "H": 22,
        "tilemap": [
            396, 397, 396, 397, 396, 397, 396, 397, 396, 397, 396, 397, 396, 397, 396, 397, 396, 397, 396, 397, 396, 397, 396, 397, 396, 397, 396, 397, 396, 397, 396, 397, 
            460, 461, 460, 461, 460, 461, 460, 461, 460, 461, 460, 461, 460, 461, 460, 461, 460, 461, 460, 461, 460, 461, 460, 461, 460, 461, 460, 461, 460, 461, 460, 461, 
            396, 397, 396, 397, 396, 397, 396, 397, 396, 397, 396, 397, 396, 397, 396, 397, 396, 397, 396, 397, 396, 397, 396, 397, 396, 397, 396, 397, 396, 397, 396, 397, 
            460, 461, 460, 461, 460, 461, 460, 461, 460, 461, 460, 461, 460, 461, 460, 461, 460, 461, 460, 461, 460, 461, 460, 461, 460, 461, 460, 461, 460, 461, 460, 461, 
            396, 397, 13, 13, 13, 13, 13, 13, 13, 13, 13, 13, 13, 13, 13, 13, 13, 13, 13, 13, 13, 13, 13, 13, 13, 13, 396, 397, 396, 397, 396, 397, 
            460, 461, 13, 13, 13, 13, 13, 13, 13, 13, 13, 13, 13, 13, 13, 13, 13, 13, 13, 13, 13, 13, 13, 13, 13, 13, 460, 461, 460, 461, 460, 461, 
            396, 397, 13, 13, 13, 143, 141, 13, 13, 13, 13, 143, 259, 260, 141, 13, 13, 13, 13, 143, 141, 13, 13, 13, 13, 13, 396, 397, 396, 397, 396, 397, 
            460, 461, 13, 13, 206, 207, 205, 206, 13, 13, 206, 207, 323, 324, 205, 206, 13, 13, 206, 207, 205, 206, 13, 13, 13, 13, 460, 461, 460, 461, 460, 461, 
            396, 397, 13, 13, 257, 258, 256, 257, 13, 13, 257, 258, 00, 00, 256, 257, 13, 13, 257, 258, 256, 257, 13, 13, 13, 13, 396, 397, 396, 397, 396, 397, 
            460, 461, 13, 13, 321, 322, 320, 321, 13, 13, 321, 322, 00, 00, 320, 321, 13, 13, 321, 322, 320, 321, 13, 13, 13, 13, 460, 461, 460, 461, 460, 461, 
            396, 397, 13, 13, 13, 13, 13, 13, 13, 13, 13, 13, 13, 13, 13, 13, 13, 13, 13, 13, 13, 13, 13, 13, 13, 13, 396, 397, 396, 397, 396, 397, 
            460, 461, 13, 13, 13, 13, 13, 13, 13, 13, 13, 13, 13, 13, 13, 13, 13, 13, 13, 13, 13, 13, 13, 13, 13, 13, 460, 461, 460, 461, 460, 461, 
            396, 397, 13, 13, 13, 13, 13, 13, 13, 13, 13, 13, 13, 13, 13, 13, 13, 13, 13, 13, 13, 13, 13, 13, 13, 13, 396, 397, 396, 397, 396, 397, 
            460, 461, 13, 13, 13, 13, 13, 13, 13, 13, 13, 13, 13, 13, 13, 13, 13, 13, 13, 13, 13, 13, 13, 13, 13, 13, 460, 461, 460, 461, 460, 461, 
            396, 397, 13, 13, 13, 13, 13, 13, 13, 13, 13, 13, 13, 13, 13, 13, 13, 13, 13, 13, 13, 13, 13, 13, 13, 13, 396, 397, 396, 397, 396, 397, 
            460, 461, 13, 13, 13, 13, 13, 13, 13, 13, 13, 13, 13, 13, 13, 13, 13, 13, 13, 13, 13, 13, 13, 13, 13, 13, 460, 461, 460, 461, 460, 461, 
            396, 397, 13, 13, 13, 13, 13, 13, 13, 13, 13, 13, 13, 13, 13, 13, 13, 13, 13, 13, 13, 13, 13, 13, 13, 13, 396, 397, 396, 397, 396, 397, 
            460, 461, 13, 13, 13, 13, 13, 13, 13, 13, 13, 13, 13, 13, 13, 13, 13, 13, 13, 13, 13, 13, 13, 13, 13, 13, 460, 461, 460, 461, 460, 461, 
            396, 397, 391, 392, 391, 392, 391, 392, 391, 392, 391, 392, 10, 74, 391, 392, 391, 392, 391, 392, 391, 392, 391, 392, 391, 392, 396, 397, 396, 397, 396, 397, 
            460, 461, 455, 456, 455, 456, 455, 456, 455, 456, 455, 456, 10, 74, 455, 456, 455, 456, 455, 456, 455, 456, 455, 456, 455, 456, 460, 461, 460, 461, 460, 461, 
            396, 397, 396, 397, 396, 397, 396, 397, 396, 397, 396, 397, 10, 74, 396, 397, 396, 397, 396, 397, 396, 397, 396, 397, 396, 397, 396, 397, 396, 397, 396, 397, 
            460, 461, 460, 461, 460, 461, 460, 461, 460, 461, 460, 461, 10, 74, 460, 461, 460, 461, 460, 461, 460, 461, 460, 461, 460, 461, 460, 461, 460, 461, 460, 461, 
        ]
    }
}