{
    "tilemap": {
        "W": 32,
        "H": 22,
        "tilemap": [
            396, 397, 396, 397, 13, 13, 13, 13, 13, 13, 13, 13, 13, 13, 13, 13, 13, 13, 13, 13, 13, 13, 13, 13, 13, 13, 13, 13, 396, 397, 396, 397, 
            460, 461, 460, 461, 13, 13, 13, 13, 13, 13, 13, 13, 13, 13, 13, 13, 13, 13, 13, 13, 13, 13, 13, 13, 13, 13, 13, 13, 460, 461, 460, 461, 
            396, 397, 396, 397, 13, 13, 13, 13, 13, 13, 13, 13, 13, 13, 13, 13, 13, 13, 13, 13, 13, 13, 13, 13, 13, 13, 13, 13, 396, 397, 396, 397, 
            460, 461, 460, 461, 13, 13, 13, 13, 13, 13, 13, 13, 13, 13, 13, 13, 13, 13, 13, 13, 13, 13, 13, 13, 13, 13, 13, 13, 460, 461, 460, 461, 
            396, 397, 396, 397, 13, 13, 13, 13, 13, 13, 13, 13, 13, 13, 13, 13, 13, 13, 13, 13, 13, 13, 13, 13, 13, 13, 13, 13, 13, 13, 13, 13, 
            460, 461, 460, 461, 13, 13, 13, 13, 13, 13, 13, 13, 13, 13, 13, 13, 13, 13, 13, 13, 13, 13, 13, 13, 13, 13, 13, 13, 13, 13, 13, 13, 
            396, 397, 396, 397, 13, 13, 270, 271, 13, 13, 13, 13, 270, 271, 13, 13, 13, 13, 270, 271, 13, 13, 13, 13, 270, 271, 13, 13, 13, 13, 13, 13, 
            460, 461, 460, 461, 13, 13, 334, 335, 13, 13, 13, 13, 334, 335, 13, 13, 13, 13, 334, 335, 13, 13, 13, 13, 334, 335, 13, 13, 13, 13, 13, 13, 
            396, 397, 396, 397, 13, 13, 13, 13, 13, 13, 13, 13, 13, 13, 13, 13, 13, 13, 13, 13, 13, 13, 13, 13, 13, 13, 13, 13, 13, 13, 13, 13, 
            460, 461, 460, 461, 13, 13, 13, 13, 13, 13, 13, 13, 13, 13, 13, 13, 13, 13, 13, 13, 13, 13, 13, 13, 13, 13, 13, 13, 13, 13, 13, 13, 
            396, 397, 396, 397, 13, 13, 270, 271, 13, 13, 13, 13, 270, 271, 13, 13, 13, 13, 270, 271, 13, 13, 13, 13, 270, 271, 13, 13, 13, 13, 13, 13, 
            460, 461, 460, 461, 13, 13, 334, 335, 13, 13, 13, 13, 334, 335, 13, 13, 13, 13, 334, 335, 13, 13, 13, 13, 334, 335, 13, 13, 13, 13, 13, 13, 
            396, 397, 396, 397, 13, 13, 13, 13, 13, 13, 13, 13, 13, 13, 13, 13, 13, 13, 13, 13, 13, 13, 13, 13, 13, 13, 13, 13, 13, 13, 13, 13, 
            460, 461, 460, 461, 13, 13, 13, 13, 13, 13, 13, 13, 13, 13, 13, 13, 13, 13, 13, 13, 13, 13, 13, 13, 13, 13, 13, 13, 13, 13, 13, 13, 
            396, 397, 396, 397, 13, 13, 270, 271, 13, 13, 13, 13, 270, 271, 13, 13, 13, 13, 270, 271, 13, 13, 13, 13, 270, 271, 13, 13, 13, 13, 13, 13, 
            460, 461, 460, 461, 13, 13, 334, 335, 13, 13, 13, 13, 334, 335, 13, 13, 13, 13, 334, 335, 13, 13, 13, 13, 334, 335, 13, 13, 13, 13, 13, 13, 
            396, 397, 396, 397, 392, 393, 13, 13, 13, 13, 13, 13, 13, 13, 13, 13, 13, 13, 13, 13, 13, 13, 13, 13, 13, 13, 13, 13, 13, 13, 13, 13, 
            460, 461, 460, 461, 456, 457, 13, 13, 13, 13, 13, 13, 13, 13, 13, 13, 13, 13, 13, 13, 13, 13, 13, 13, 13, 13, 13, 13, 13, 13, 13, 13, 
            396, 397, 396, 397, 396, 397, 391, 392, 391, 392, 391, 392, 391, 392, 391, 392, 391, 392, 391, 392, 391, 392, 391, 392, 391, 392, 391, 392, 10, 74, 391, 392, 
            460, 461, 460, 461, 460, 461, 455, 456, 455, 456, 455, 456, 455, 456, 455, 456, 455, 456, 455, 456, 455, 456, 455, 456, 455, 456, 455, 456, 10, 74, 455, 456, 
            396, 397, 396, 397, 396, 397, 396, 397, 396, 397, 396, 397, 396, 397, 396, 397, 396, 397, 396, 397, 396, 397, 396, 397, 396, 397, 396, 397, 10, 74, 396, 397, 
            460, 461, 460, 461, 460, 461, 460, 461, 460, 461, 460, 461, 460, 461, 460, 461, 460, 461, 460, 461, 460, 461, 460, 461, 460, 461, 460, 461, 10, 74, 460, 461, 
        ]
    }
}