{
    "tilemap": {
        "W": 32,
        "H": 22,
        "tilemap": [
            168, 168, 168, 168, 168, 168, 168, 168, 168, 168, 168, 168, 168, 168, 168, 168, 168, 168, 168, 168, 168, 168, 168, 168, 168, 168, 168, 168, 168, 168, 168, 168, 
            168, 168, 168, 168, 168, 168, 168, 168, 168, 168, 168, 168, 168, 168, 168, 168, 168, 168, 168, 168, 168, 168, 168, 168, 168, 168, 168, 168, 168, 168, 168, 168, 
            168, 168, 168, 168, 168, 168, 168, 168, 168, 168, 168, 168, 168, 168, 168, 168, 168, 168, 168, 168, 168, 168, 168, 168, 168, 168, 168, 168, 168, 168, 168, 168, 
            168, 168, 168, 168, 168, 168, 168, 168, 168, 168, 168, 168, 168, 168, 168, 168, 168, 168, 168, 168, 168, 168, 168, 168, 168, 168, 168, 168, 168, 168, 168, 168, 
            168, 168, 168, 168, 168, 168, 168, 168, 168, 168, 168, 168, 168, 168, 168, 168, 168, 168, 168, 168, 168, 168, 168, 168, 168, 168, 168, 168, 168, 168, 168, 168, 
            168, 168, 168, 168, 168, 168, 168, 168, 168, 168, 168, 168, 168, 168, 168, 168, 168, 168, 168, 168, 168, 168, 168, 168, 168, 168, 168, 168, 168, 168, 168, 168, 
            168, 168, 168, 168, 168, 168, 168, 168, 168, 168, 168, 168, 168, 168, 168, 168, 168, 168, 168, 168, 168, 168, 168, 168, 168, 168, 168, 168, 168, 168, 168, 168, 
            168, 168, 168, 168, 168, 168, 168, 168, 168, 168, 168, 168, 168, 168, 168, 168, 168, 168, 168, 168, 168, 168, 168, 168, 168, 168, 168, 168, 168, 168, 168, 168, 
            168, 168, 168, 168, 168, 168, 168, 168, 168, 168, 168, 168, 168, 168, 168, 168, 43, 43, 168, 168, 168, 168, 168, 168, 168, 168, 168, 168, 168, 168, 168, 168, 
            164, 164, 164, 164, 164, 164, 164, 164, 168, 168, 168, 168, 168, 168, 168, 168, 107, 107, 164, 164, 164, 164, 164, 164, 164, 164, 164, 164, 164, 164, 164, 164, 
            045, 45, 45, 45, 45, 45, 45, 45, 45, 46, 168, 168, 168, 168, 44, 45, 45, 45, 45, 45, 45, 45, 45, 45, 45, 45, 45, 45, 45, 45, 45, 45, 
            045, 45, 45, 45, 45, 45, 45, 45, 45, 110, 168, 168, 168, 168, 108, 45, 45, 45, 45, 45, 45, 45, 45, 45, 45, 45, 45, 45, 45, 45, 45, 45, 
            423, 424, 423, 424, 45, 45, 45, 45, 45, 45, 168, 168, 168, 168, 45, 45, 45, 45, 45, 45, 45, 45, 45, 45, 45, 45, 45, 45, 423, 424, 423, 424, 
            487, 488, 487, 488, 45, 45, 45, 45, 45, 45, 168, 168, 168, 168, 45, 45, 45, 45, 45, 45, 45, 45, 45, 45, 45, 45, 45, 45, 487, 488, 487, 488, 
            428, 429, 428, 429, 45, 45, 45, 45, 45, 45, 168, 168, 168, 168, 45, 45, 45, 45, 45, 45, 45, 45, 45, 45, 45, 45, 45, 45, 428, 429, 428, 429, 
            492, 493, 492, 493, 45, 45, 45, 45, 45, 45, 168, 168, 168, 168, 45, 45, 45, 45, 45, 45, 45, 45, 45, 45, 45, 45, 45, 45, 492, 493, 492, 493, 
            428, 429, 428, 429, 45, 45, 45, 45, 45, 45, 168, 168, 168, 168, 45, 45, 45, 45, 45, 45, 45, 45, 45, 45, 45, 45, 45, 45, 428, 429, 428, 429, 
            492, 493, 492, 493, 45, 45, 45, 45, 45, 45, 168, 168, 168, 168, 45, 45, 45, 45, 45, 45, 45, 45, 45, 45, 45, 45, 45, 45, 492, 493, 492, 493, 
            428, 429, 428, 429, 45, 45, 45, 45, 45, 45, 168, 168, 168, 168, 45, 45, 45, 45, 45, 45, 423, 424, 45, 45, 423, 424, 45, 45, 428, 429, 428, 429, 
            492, 493, 492, 493, 45, 45, 45, 45, 45, 45, 168, 168, 168, 168, 45, 45, 45, 45, 45, 45, 487, 488, 45, 45, 487, 488, 45, 45, 492, 493, 492, 493, 
            428, 429, 428, 429, 45, 45, 45, 45, 45, 45, 168, 168, 168, 168, 45, 45, 45, 45, 45, 45, 428, 429, 45, 45, 428, 429, 45, 45, 428, 429, 428, 429, 
            492, 493, 492, 493, 45, 45, 45, 45, 45, 45, 168, 168, 168, 168, 45, 45, 45, 45, 45, 45, 492, 493, 45, 45, 492, 493, 45, 45, 492, 493, 492, 493, 
        ]
    }
}