{
    "tilemap": {
        "W": 32,
        "H": 22,
        "tilemap": [
            444, 445, 444, 445, 444, 445, 444, 445, 444, 445, 444, 445, 444, 445, 444, 445, 444, 445, 444, 445, 444, 445, 444, 445, 444, 445, 444, 445, 444, 445, 444, 445, 
            508, 509, 508, 509, 508, 509, 508, 509, 508, 509, 508, 509, 508, 509, 508, 509, 508, 509, 508, 509, 508, 509, 508, 509, 508, 509, 508, 509, 508, 509, 508, 509, 
            444, 445, 444, 445, 00, 00, 444, 445, 444, 445, 444, 445, 444, 445, 444, 445, 444, 445, 444, 445, 444, 445, 444, 445, 444, 445, 444, 445, 444, 445, 444, 445, 
            508, 509, 508, 509, 00, 00, 508, 509, 508, 509, 508, 509, 508, 509, 508, 509, 508, 509, 508, 509, 508, 509, 508, 509, 508, 509, 508, 509, 508, 509, 508, 509, 
            444, 445, 446, 447, 45, 45, 45, 45, 45, 45, 45, 45, 45, 45, 45, 45, 45, 45, 45, 45, 45, 45, 45, 45, 45, 45, 45, 45, 442, 443, 444, 445, 
            508, 509, 510, 495, 45, 45, 45, 45, 45, 45, 45, 45, 45, 45, 45, 45, 45, 45, 45, 45, 45, 45, 45, 45, 45, 45, 45, 45, 506, 507, 508, 509, 
            444, 445, 45, 45, 45, 45, 246, 247, 247, 247, 247, 247, 247, 247, 247, 247, 247, 247, 247, 247, 247, 247, 247, 248, 45, 45, 45, 45, 45, 45, 444, 445, 
            508, 509, 45, 45, 45, 45, 183, 184, 184, 184, 184, 184, 184, 184, 184, 184, 184, 184, 184, 184, 184, 184, 184, 185, 45, 45, 45, 45, 45, 45, 508, 509, 
            444, 445, 45, 45, 45, 45, 183, 184, 184, 184, 184, 184, 184, 184, 184, 184, 184, 184, 184, 184, 184, 184, 184, 185, 45, 45, 45, 45, 45, 45, 444, 445, 
            508, 509, 45, 45, 45, 45, 249, 184, 184, 184, 184, 184, 184, 184, 184, 184, 184, 184, 184, 184, 184, 184, 184, 251, 45, 45, 45, 45, 45, 45, 508, 509, 
            444, 445, 45, 45, 45, 45, 183, 184, 184, 184, 184, 184, 184, 184, 184, 184, 184, 184, 184, 184, 184, 184, 184, 185, 45, 45, 45, 45, 45, 45, 444, 445, 
            508, 509, 45, 45, 45, 45, 249, 184, 184, 184, 184, 184, 184, 184, 184, 184, 184, 184, 184, 184, 184, 184, 184, 251, 45, 45, 45, 45, 45, 45, 508, 509, 
            444, 445, 45, 45, 45, 45, 249, 184, 184, 184, 184, 184, 184, 184, 184, 184, 184, 184, 184, 184, 184, 184, 184, 251, 45, 45, 45, 45, 45, 45, 444, 445, 
            508, 509, 45, 45, 45, 45, 186, 180, 180, 180, 184, 184, 184, 184, 184, 184, 180, 180, 180, 180, 180, 180, 180, 188, 45, 45, 45, 45, 45, 45, 508, 509, 
            444, 445, 45, 45, 45, 45, 45, 45, 45, 45, 45, 62, 184, 184, 60, 45, 45, 45, 45, 45, 45, 45, 45, 45, 45, 45, 45, 45, 45, 45, 444, 445, 
            508, 509, 45, 45, 45, 45, 45, 45, 45, 45, 45, 110, 184, 184, 108, 45, 45, 45, 45, 45, 45, 45, 45, 45, 45, 45, 45, 45, 45, 45, 508, 509, 
            444, 445, 440, 441, 45, 45, 45, 45, 45, 45, 45, 45, 184, 184, 45, 45, 45, 45, 45, 45, 45, 45, 45, 45, 45, 45, 45, 45, 438, 439, 444, 445, 
            508, 509, 504, 505, 45, 45, 45, 45, 45, 45, 45, 45, 184, 184, 45, 45, 45, 45, 45, 45, 45, 45, 45, 45, 45, 45, 45, 45, 502, 503, 508, 509, 
            444, 445, 444, 445, 439, 440, 439, 440, 439, 440, 439, 440, 184, 184, 439, 440, 439, 440, 439, 440, 439, 440, 439, 440, 439, 440, 58, 122, 444, 445, 444, 445, 
            508, 509, 508, 509, 503, 504, 503, 504, 503, 504, 503, 504, 184, 184, 503, 504, 503, 504, 503, 504, 503, 504, 503, 504, 503, 504, 58, 122, 508, 509, 508, 509, 
            444, 445, 444, 445, 444, 445, 444, 445, 444, 445, 444, 445, 184, 184, 444, 445, 444, 445, 444, 445, 444, 445, 444, 445, 444, 445, 58, 122, 444, 445, 444, 445, 
            508, 509, 508, 509, 508, 509, 508, 509, 508, 509, 508, 509, 184, 184, 508, 509, 508, 509, 508, 509, 508, 509, 508, 509, 508, 509, 58, 122, 508, 509, 508, 509, 
        ]
    }
}