{
    "tilemap": {
        "W": 32,
        "H": 22,
        "tilemap": [
            184, 184, 444, 445, 444, 445, 444, 445, 444, 445, 444, 445, 444, 445, 444, 445, 444, 445, 444, 445, 444, 445, 444, 445, 444, 445, 444, 445, 444, 445, 184, 184, 
            184, 184, 508, 509, 508, 509, 508, 509, 508, 509, 508, 509, 508, 509, 508, 509, 508, 509, 508, 509, 508, 509, 508, 509, 508, 509, 508, 509, 508, 509, 184, 184, 
            184, 184, 444, 445, 444, 445, 444, 445, 444, 445, 444, 445, 444, 445, 444, 445, 444, 445, 444, 445, 444, 445, 444, 445, 444, 445, 444, 445, 444, 445, 184, 184, 
            184, 184, 508, 509, 508, 509, 508, 509, 508, 509, 508, 509, 508, 509, 508, 509, 508, 509, 508, 509, 508, 509, 508, 509, 508, 509, 508, 509, 508, 509, 184, 184, 
            184, 184, 444, 445, 45, 45, 45, 45, 45, 45, 45, 45, 45, 45, 45, 45, 45, 45, 45, 45, 45, 45, 45, 45, 45, 45, 45, 45, 444, 445, 184, 184, 
            184, 184, 508, 509, 45, 45, 45, 45, 45, 45, 45, 45, 45, 45, 45, 45, 45, 45, 45, 45, 45, 45, 45, 45, 45, 45, 45, 45, 508, 509, 184, 184, 
            184, 184, 444, 445, 45, 45, 312, 313, 309, 45, 45, 45, 312, 313, 314, 315, 309, 45, 45, 45, 312, 313, 309, 45, 45, 45, 45, 45, 444, 445, 184, 184, 
            184, 184, 508, 509, 45, 45, 376, 377, 373, 45, 45, 45, 376, 377, 378, 379, 373, 45, 45, 45, 376, 377, 373, 45, 45, 45, 45, 45, 508, 509, 184, 184, 
            184, 184, 444, 445, 45, 45, 45, 311, 316, 317, 45, 45, 45, 311, 00, 00, 316, 317, 45, 45, 45, 311, 316, 317, 45, 45, 45, 45, 444, 445, 184, 184, 
            184, 184, 508, 509, 45, 45, 45, 375, 380, 381, 45, 45, 45, 375, 00, 00, 380, 381, 45, 45, 45, 375, 380, 381, 45, 45, 45, 45, 508, 509, 184, 184, 
            184, 184, 444, 445, 45, 45, 45, 45, 45, 45, 45, 45, 45, 45, 45, 45, 45, 45, 45, 45, 45, 45, 45, 45, 45, 45, 45, 45, 45, 45, 59, 59, 
            184, 184, 508, 509, 45, 45, 45, 45, 45, 45, 45, 45, 45, 45, 45, 45, 45, 45, 45, 45, 45, 45, 45, 45, 45, 45, 45, 45, 45, 45, 123, 123, 
            184, 184, 444, 445, 45, 45, 45, 45, 312, 313, 309, 45, 45, 45, 45, 45, 45, 45, 312, 313, 309, 45, 45, 45, 45, 45, 45, 45, 439, 440, 184, 184, 
            184, 184, 508, 509, 45, 45, 45, 45, 376, 377, 373, 45, 45, 45, 45, 45, 45, 45, 376, 377, 373, 45, 45, 45, 45, 45, 45, 45, 503, 504, 184, 184, 
            184, 184, 444, 445, 45, 45, 45, 45, 45, 311, 316, 317, 45, 45, 45, 45, 45, 45, 45, 311, 316, 317, 45, 45, 45, 45, 45, 45, 444, 445, 184, 184, 
            184, 184, 508, 509, 45, 45, 45, 45, 45, 375, 380, 381, 45, 45, 45, 45, 45, 45, 45, 375, 380, 381, 45, 45, 45, 45, 45, 45, 508, 509, 184, 184, 
            184, 184, 444, 445, 45, 45, 45, 45, 45, 45, 45, 45, 45, 45, 45, 45, 45, 45, 45, 45, 45, 45, 45, 45, 45, 45, 45, 45, 444, 445, 184, 184, 
            184, 184, 508, 509, 45, 45, 45, 45, 45, 45, 45, 45, 45, 45, 45, 45, 45, 45, 45, 45, 45, 45, 45, 45, 45, 45, 45, 45, 508, 509, 184, 184, 
            184, 184, 444, 445, 439, 440, 439, 440, 439, 440, 439, 440, 439, 440, 439, 440, 439, 440, 439, 440, 439, 440, 439, 440, 439, 440, 439, 440, 444, 445, 184, 184, 
            184, 184, 508, 509, 503, 504, 503, 504, 503, 504, 503, 504, 503, 504, 503, 504, 503, 504, 503, 504, 503, 504, 503, 504, 503, 504, 503, 504, 508, 509, 184, 184, 
            184, 184, 444, 445, 444, 445, 444, 445, 444, 445, 444, 445, 444, 445, 444, 445, 444, 445, 444, 445, 444, 445, 444, 445, 444, 445, 444, 445, 444, 445, 184, 184, 
            184, 184, 508, 509, 508, 509, 508, 509, 508, 509, 508, 509, 508, 509, 508, 509, 508, 509, 508, 509, 508, 509, 508, 509, 508, 509, 508, 509, 508, 509, 184, 184, 
        ]
    }
}