{
    "tilemap": {
        "W": 32,
        "H": 22,
        "tilemap": [
            444, 445, 444, 445, 444, 445, 444, 445, 444, 445, 444, 445, 444, 445, 444, 445, 444, 445, 444, 445, 444, 445, 444, 445, 444, 445, 444, 445, 444, 445, 444, 445, 
            508, 509, 508, 509, 508, 509, 508, 509, 508, 509, 508, 509, 508, 509, 508, 509, 508, 509, 508, 509, 508, 509, 508, 509, 508, 509, 508, 509, 508, 509, 508, 509, 
            444, 445, 444, 445, 444, 445, 444, 445, 444, 445, 444, 445, 444, 445, 444, 445, 446, 447, 442, 443, 444, 445, 444, 445, 444, 445, 444, 445, 444, 445, 444, 445, 
            508, 509, 508, 509, 508, 509, 508, 509, 508, 509, 508, 509, 508, 509, 508, 509, 510, 495, 506, 507, 508, 509, 508, 509, 508, 509, 508, 509, 508, 509, 508, 509, 
            444, 445, 444, 445, 444, 445, 444, 445, 444, 445, 444, 445, 444, 445, 444, 445, 45, 45, 45, 45, 442, 443, 446, 447, 45, 45, 45, 45, 442, 443, 446, 447, 
            508, 509, 508, 509, 508, 509, 508, 509, 508, 509, 508, 509, 508, 509, 508, 509, 45, 45, 45, 45, 506, 507, 510, 495, 45, 45, 45, 45, 506, 507, 510, 495, 
            444, 445, 444, 445, 444, 445, 444, 445, 444, 445, 444, 445, 444, 445, 444, 445, 45, 45, 45, 45, 45, 45, 45, 45, 45, 45, 45, 45, 45, 45, 45, 45, 
            508, 509, 508, 509, 508, 509, 508, 509, 508, 509, 508, 509, 508, 509, 508, 509, 45, 45, 45, 45, 45, 45, 45, 45, 45, 45, 45, 45, 45, 45, 45, 45, 
            444, 445, 444, 445, 444, 445, 444, 445, 444, 445, 444, 445, 444, 445, 446, 447, 45, 45, 45, 45, 45, 45, 45, 45, 45, 45, 45, 45, 45, 45, 45, 45, 
            508, 509, 508, 509, 508, 509, 508, 509, 508, 509, 508, 509, 508, 509, 510, 495, 45, 45, 45, 45, 45, 45, 45, 45, 45, 45, 45, 45, 45, 45, 45, 45, 
            045, 45, 442, 443, 446, 447, 45, 45, 45, 45, 442, 443, 446, 447, 45, 45, 45, 45, 45, 45, 45, 45, 45, 45, 45, 45, 45, 45, 45, 45, 45, 45, 
            045, 45, 506, 507, 510, 495, 45, 45, 45, 45, 506, 507, 510, 495, 45, 45, 45, 45, 45, 45, 45, 45, 45, 45, 45, 45, 45, 45, 45, 45, 45, 45, 
            045, 45, 45, 45, 45, 45, 45, 45, 45, 45, 45, 45, 45, 45, 45, 45, 45, 45, 45, 45, 45, 45, 45, 45, 45, 45, 45, 45, 45, 45, 45, 45, 
            045, 45, 45, 45, 45, 45, 45, 45, 45, 45, 45, 45, 45, 45, 45, 45, 45, 45, 45, 45, 45, 45, 45, 45, 45, 45, 45, 45, 45, 45, 45, 45, 
            045, 45, 45, 45, 45, 45, 45, 45, 45, 45, 45, 45, 45, 45, 45, 45, 45, 45, 45, 45, 45, 45, 45, 45, 45, 45, 45, 45, 45, 45, 45, 45, 
            045, 45, 45, 45, 45, 45, 45, 45, 45, 45, 45, 45, 45, 45, 45, 45, 45, 45, 45, 45, 45, 45, 45, 45, 45, 45, 45, 45, 45, 45, 45, 45, 
            045, 45, 438, 439, 440, 441, 45, 45, 45, 45, 438, 439, 440, 441, 45, 45, 45, 45, 45, 45, 438, 439, 440, 441, 45, 45, 45, 45, 438, 439, 440, 441, 
            045, 45, 502, 503, 504, 505, 45, 45, 45, 45, 502, 503, 504, 505, 45, 45, 45, 45, 45, 45, 502, 503, 504, 505, 45, 45, 45, 45, 502, 503, 504, 505, 
            439, 440, 444, 445, 444, 445, 58, 122, 439, 440, 444, 445, 444, 445, 439, 440, 440, 441, 438, 439, 444, 445, 444, 445, 439, 440, 58, 122, 444, 445, 444, 445, 
            503, 504, 508, 509, 508, 509, 58, 122, 503, 504, 508, 509, 508, 509, 503, 504, 504, 505, 502, 503, 508, 509, 508, 509, 503, 504, 58, 122, 508, 509, 508, 509, 
            444, 445, 444, 445, 444, 445, 58, 122, 444, 445, 444, 445, 444, 445, 444, 445, 444, 445, 444, 445, 444, 445, 444, 445, 444, 445, 58, 122, 444, 445, 444, 445, 
            508, 509, 508, 509, 508, 509, 58, 122, 508, 509, 508, 509, 508, 509, 508, 509, 508, 509, 508, 509, 508, 509, 508, 509, 508, 509, 58, 122, 508, 509, 508, 509, 
        ]
    }
}