{
    "tilemap": {
        "W": 32,
        "H": 22,
        "tilemap": [
            184, 184, 184, 184, 184, 184, 184, 184, 184, 184, 184, 184, 184, 184, 184, 184, 184, 184, 184, 184, 184, 184, 184, 184, 184, 184, 184, 184, 184, 184, 184, 184, 
            184, 184, 184, 184, 184, 184, 184, 184, 184, 184, 184, 184, 184, 184, 184, 184, 184, 184, 184, 184, 184, 184, 184, 184, 184, 184, 184, 184, 184, 184, 184, 184, 
            184, 184, 184, 184, 184, 184, 184, 184, 184, 184, 184, 184, 184, 184, 184, 184, 184, 184, 184, 184, 184, 184, 184, 184, 184, 184, 184, 184, 184, 184, 184, 184, 
            184, 184, 184, 184, 184, 184, 184, 184, 184, 184, 184, 184, 184, 184, 184, 184, 184, 184, 184, 184, 184, 184, 184, 184, 184, 184, 184, 184, 184, 184, 184, 184, 
            184, 184, 184, 184, 184, 184, 184, 184, 184, 184, 184, 184, 184, 184, 184, 184, 184, 184, 184, 184, 184, 184, 184, 184, 184, 184, 184, 184, 184, 184, 184, 184, 
            184, 184, 184, 184, 184, 184, 184, 184, 184, 184, 184, 184, 184, 184, 184, 184, 184, 184, 184, 184, 184, 184, 184, 184, 184, 184, 184, 184, 184, 184, 184, 184, 
            444, 445, 444, 445, 444, 445, 444, 445, 444, 445, 444, 445, 444, 445, 444, 445, 444, 445, 444, 445, 184, 184, 184, 184, 184, 184, 184, 184, 184, 184, 184, 184, 
            508, 509, 508, 509, 508, 509, 508, 509, 508, 509, 508, 509, 508, 509, 508, 509, 508, 509, 508, 509, 184, 184, 184, 184, 184, 184, 184, 184, 184, 184, 184, 184, 
            444, 445, 444, 445, 444, 445, 444, 445, 444, 445, 00, 00, 444, 445, 444, 445, 444, 445, 444, 445, 184, 184, 184, 184, 184, 184, 184, 184, 184, 184, 184, 184, 
            508, 509, 508, 509, 508, 509, 508, 509, 508, 509, 00, 00, 508, 509, 508, 509, 508, 509, 508, 509, 184, 184, 184, 184, 184, 184, 184, 184, 184, 184, 184, 184, 
            444, 445, 444, 445, 444, 445, 444, 445, 444, 445, 45, 45, 444, 445, 444, 445, 444, 445, 444, 445, 184, 184, 184, 184, 184, 184, 184, 184, 184, 184, 184, 184, 
            508, 509, 508, 509, 508, 509, 508, 509, 508, 509, 45, 45, 508, 509, 508, 509, 508, 509, 508, 509, 184, 184, 184, 184, 184, 184, 184, 184, 184, 184, 184, 184, 
            444, 445, 444, 445, 444, 445, 444, 445, 444, 445, 45, 45, 444, 445, 444, 445, 444, 445, 444, 445, 184, 184, 184, 184, 184, 184, 184, 184, 184, 184, 184, 184, 
            508, 509, 508, 509, 508, 509, 508, 509, 508, 509, 45, 45, 508, 509, 508, 509, 508, 509, 508, 509, 184, 184, 184, 184, 184, 184, 184, 184, 184, 184, 184, 184, 
            444, 445, 444, 445, 444, 445, 444, 445, 444, 445, 45, 45, 444, 445, 444, 445, 444, 445, 444, 445, 184, 184, 184, 184, 184, 184, 184, 184, 184, 184, 184, 184, 
            508, 509, 508, 509, 508, 509, 508, 509, 508, 509, 45, 45, 508, 509, 508, 509, 508, 509, 508, 509, 184, 184, 184, 184, 184, 184, 184, 184, 184, 184, 184, 184, 
            444, 445, 444, 445, 444, 445, 444, 445, 444, 445, 58, 122, 444, 445, 444, 445, 444, 445, 444, 445, 184, 184, 184, 184, 184, 184, 184, 184, 184, 184, 184, 184, 
            508, 509, 508, 509, 508, 509, 508, 509, 508, 509, 58, 122, 508, 509, 508, 509, 508, 509, 508, 509, 184, 184, 184, 184, 184, 184, 184, 184, 184, 184, 184, 184, 
            444, 445, 444, 445, 444, 445, 444, 445, 444, 445, 58, 122, 444, 445, 444, 445, 444, 445, 444, 445, 184, 184, 184, 184, 184, 184, 184, 184, 184, 184, 184, 184, 
            508, 509, 508, 509, 508, 509, 508, 509, 508, 509, 58, 122, 508, 509, 508, 509, 508, 509, 508, 509, 184, 184, 184, 184, 184, 184, 184, 184, 184, 184, 184, 184, 
            444, 445, 444, 445, 444, 445, 444, 445, 444, 445, 58, 122, 444, 445, 444, 445, 444, 445, 444, 445, 444, 445, 444, 445, 444, 445, 444, 445, 444, 445, 444, 445, 
            508, 509, 508, 509, 508, 509, 508, 509, 508, 509, 58, 122, 508, 509, 508, 509, 508, 509, 508, 509, 508, 509, 508, 509, 508, 509, 508, 509, 508, 509, 508, 509, 
        ]
    }
}