{
    "tilemap": {
        "W": 32,
        "H": 22,
        "tilemap": [
            444, 445, 444, 445, 444, 445, 444, 445, 444, 445, 444, 445, 444, 445, 444, 445, 444, 445, 444, 445, 444, 445, 444, 445, 444, 445, 444, 445, 444, 445, 184, 184, 
            508, 509, 508, 509, 508, 509, 508, 509, 508, 509, 508, 509, 508, 509, 508, 509, 508, 509, 508, 509, 508, 509, 508, 509, 508, 509, 508, 509, 508, 509, 184, 184, 
            444, 445, 444, 445, 444, 445, 444, 445, 444, 445, 444, 445, 444, 445, 444, 445, 444, 445, 444, 445, 444, 445, 444, 445, 444, 445, 444, 445, 444, 445, 184, 184, 
            508, 509, 508, 509, 508, 509, 508, 509, 508, 509, 508, 509, 508, 509, 508, 509, 508, 509, 508, 509, 508, 509, 508, 509, 508, 509, 508, 509, 508, 509, 184, 184, 
            045, 45, 45, 45, 45, 45, 45, 45, 45, 45, 45, 45, 45, 45, 45, 45, 45, 45, 45, 45, 45, 45, 45, 45, 45, 45, 45, 45, 444, 445, 184, 184, 
            045, 45, 45, 45, 45, 45, 45, 45, 45, 45, 45, 45, 45, 45, 45, 45, 45, 45, 45, 45, 45, 45, 45, 45, 45, 45, 45, 45, 508, 509, 184, 184, 
            045, 45, 45, 45, 296, 297, 293, 45, 45, 45, 296, 297, 298, 299, 293, 45, 45, 45, 45, 45, 296, 297, 293, 45, 45, 45, 45, 45, 444, 445, 184, 184, 
            045, 45, 45, 45, 360, 361, 357, 45, 45, 45, 360, 361, 362, 363, 357, 45, 45, 45, 45, 45, 360, 361, 357, 45, 45, 45, 45, 45, 508, 509, 184, 184, 
            045, 45, 45, 45, 45, 295, 300, 301, 45, 45, 45, 295, 00, 00, 300, 301, 45, 45, 45, 45, 45, 295, 300, 301, 45, 45, 45, 45, 444, 445, 184, 184, 
            045, 45, 45, 45, 45, 359, 364, 365, 45, 45, 45, 359, 00, 00, 364, 365, 45, 45, 45, 45, 45, 359, 364, 365, 45, 45, 45, 45, 508, 509, 184, 184, 
            045, 45, 45, 45, 45, 45, 45, 45, 45, 45, 45, 45, 45, 45, 45, 45, 45, 45, 45, 45, 45, 45, 45, 45, 45, 45, 45, 45, 444, 445, 184, 184, 
            045, 45, 45, 45, 45, 45, 45, 45, 45, 45, 45, 45, 45, 45, 45, 45, 45, 45, 45, 45, 45, 45, 45, 45, 45, 45, 45, 45, 508, 509, 184, 184, 
            045, 45, 45, 45, 45, 45, 45, 45, 296, 297, 293, 45, 45, 45, 45, 45, 296, 297, 293, 45, 45, 45, 296, 297, 293, 45, 45, 45, 444, 445, 184, 184, 
            045, 45, 45, 45, 45, 45, 45, 45, 360, 361, 357, 45, 45, 45, 45, 45, 360, 361, 357, 45, 45, 45, 360, 361, 357, 45, 45, 45, 508, 509, 184, 184, 
            045, 45, 45, 45, 45, 45, 45, 45, 45, 295, 300, 301, 45, 45, 45, 45, 45, 295, 300, 301, 45, 45, 45, 295, 300, 301, 45, 45, 444, 445, 184, 184, 
            045, 45, 45, 45, 45, 45, 45, 45, 45, 359, 364, 365, 45, 45, 45, 45, 45, 359, 364, 365, 45, 45, 45, 359, 364, 365, 45, 45, 508, 509, 184, 184, 
            045, 45, 45, 45, 45, 45, 45, 45, 45, 45, 45, 45, 45, 45, 45, 45, 45, 45, 45, 45, 45, 45, 45, 45, 45, 45, 45, 45, 444, 445, 184, 184, 
            045, 45, 45, 45, 45, 45, 45, 45, 45, 45, 45, 45, 45, 45, 45, 45, 45, 45, 45, 45, 45, 45, 45, 45, 45, 45, 45, 45, 508, 509, 184, 184, 
            439, 440, 439, 440, 439, 440, 439, 440, 439, 440, 439, 440, 439, 440, 439, 440, 439, 440, 439, 440, 439, 440, 439, 440, 439, 440, 439, 440, 444, 445, 184, 184, 
            503, 504, 503, 504, 503, 504, 503, 504, 503, 504, 503, 504, 503, 504, 503, 504, 503, 504, 503, 504, 503, 504, 503, 504, 503, 504, 503, 504, 508, 509, 184, 184, 
            444, 445, 444, 445, 444, 445, 444, 445, 444, 445, 444, 445, 444, 445, 444, 445, 444, 445, 444, 445, 444, 445, 444, 445, 444, 445, 444, 445, 444, 445, 184, 184, 
            508, 509, 508, 509, 508, 509, 508, 509, 508, 509, 508, 509, 508, 509, 508, 509, 508, 509, 508, 509, 508, 509, 508, 509, 508, 509, 508, 509, 508, 509, 184, 184, 
        ]
    }
}