{
    "tilemap": {
        "W": 32,
        "H": 22,
        "tilemap": [
            418, 419, 418, 419, 418, 419, 45, 45, 418, 419, 418, 419, 418, 419, 418, 419, 418, 419, 418, 419, 418, 419, 418, 419, 45, 45, 418, 419, 418, 419, 418, 419, 
            482, 483, 482, 483, 482, 483, 45, 45, 482, 483, 482, 483, 482, 483, 482, 483, 482, 483, 482, 483, 482, 483, 482, 483, 45, 45, 482, 483, 482, 483, 482, 483, 
            418, 419, 418, 419, 418, 419, 45, 45, 418, 419, 418, 419, 418, 419, 418, 419, 418, 419, 418, 419, 418, 419, 418, 419, 45, 45, 418, 419, 418, 419, 418, 419, 
            482, 483, 482, 483, 482, 483, 45, 45, 482, 483, 482, 483, 482, 483, 482, 483, 482, 483, 482, 483, 482, 483, 482, 483, 45, 45, 482, 483, 482, 483, 482, 483, 
            045, 45, 45, 45, 45, 45, 45, 45, 45, 45, 45, 45, 45, 45, 45, 45, 45, 45, 45, 45, 418, 419, 45, 45, 45, 45, 418, 419, 418, 419, 418, 419, 
            045, 45, 45, 45, 45, 45, 45, 45, 45, 45, 45, 45, 45, 45, 45, 45, 45, 45, 45, 45, 482, 483, 45, 45, 45, 45, 482, 483, 482, 483, 482, 483, 
            418, 419, 418, 419, 45, 45, 45, 45, 418, 419, 418, 419, 418, 419, 418, 419, 418, 419, 418, 419, 418, 419, 418, 419, 45, 45, 418, 419, 418, 419, 418, 419, 
            482, 483, 482, 483, 45, 45, 45, 45, 482, 483, 482, 483, 482, 483, 482, 483, 482, 483, 482, 483, 482, 483, 482, 483, 45, 45, 482, 483, 482, 483, 482, 483, 
            418, 419, 418, 419, 45, 45, 45, 45, 418, 419, 418, 419, 418, 419, 418, 419, 418, 419, 418, 419, 418, 419, 418, 419, 45, 45, 45, 45, 45, 45, 45, 45, 
            482, 483, 482, 483, 45, 45, 45, 45, 482, 483, 482, 483, 482, 483, 482, 483, 482, 483, 482, 483, 482, 483, 482, 483, 45, 45, 45, 45, 45, 45, 45, 45, 
            418, 419, 418, 419, 45, 45, 45, 45, 418, 419, 418, 419, 418, 419, 418, 419, 418, 419, 418, 419, 418, 419, 418, 419, 45, 45, 45, 45, 45, 45, 45, 45, 
            482, 483, 482, 483, 45, 45, 45, 45, 482, 483, 482, 483, 482, 483, 482, 483, 482, 483, 482, 483, 482, 483, 482, 483, 45, 45, 45, 45, 45, 45, 45, 45, 
            418, 419, 418, 419, 45, 45, 45, 45, 418, 419, 418, 419, 418, 419, 418, 419, 418, 419, 418, 419, 418, 419, 418, 419, 45, 45, 45, 45, 45, 45, 45, 45, 
            482, 483, 482, 483, 45, 45, 45, 45, 482, 483, 482, 483, 482, 483, 482, 483, 482, 483, 482, 483, 482, 483, 482, 483, 45, 45, 45, 45, 45, 45, 45, 45, 
            418, 419, 418, 419, 45, 45, 45, 45, 418, 419, 418, 419, 418, 419, 418, 419, 418, 419, 418, 419, 418, 419, 418, 419, 418, 419, 418, 419, 418, 419, 418, 419, 
            482, 483, 482, 483, 45, 45, 45, 45, 482, 483, 482, 483, 482, 483, 482, 483, 482, 483, 482, 483, 482, 483, 482, 483, 482, 483, 482, 483, 482, 483, 482, 483, 
            045, 45, 45, 45, 45, 45, 45, 45, 418, 419, 418, 419, 418, 419, 418, 419, 418, 419, 418, 419, 418, 419, 418, 419, 418, 419, 418, 419, 418, 419, 418, 419, 
            045, 45, 45, 45, 45, 45, 45, 45, 482, 483, 482, 483, 482, 483, 482, 483, 482, 483, 482, 483, 482, 483, 482, 483, 482, 483, 482, 483, 482, 483, 482, 483, 
            418, 419, 418, 419, 418, 419, 418, 419, 418, 419, 418, 419, 418, 419, 418, 419, 418, 419, 418, 419, 418, 419, 418, 419, 418, 419, 418, 419, 418, 419, 418, 419, 
            482, 483, 482, 483, 482, 483, 482, 483, 482, 483, 482, 483, 482, 483, 482, 483, 482, 483, 482, 483, 482, 483, 482, 483, 482, 483, 482, 483, 482, 483, 482, 483, 
            418, 419, 418, 419, 418, 419, 418, 419, 418, 419, 418, 419, 418, 419, 418, 419, 418, 419, 418, 419, 418, 419, 418, 419, 418, 419, 418, 419, 418, 419, 418, 419, 
            482, 483, 482, 483, 482, 483, 482, 483, 482, 483, 482, 483, 482, 483, 482, 483, 482, 483, 482, 483, 482, 483, 482, 483, 482, 483, 482, 483, 482, 483, 482, 483, 
        ]
    }
}