{
    "tilemap": {
        "W": 32,
        "H": 22,
        "tilemap": [
            168, 168, 168, 168, 168, 168, 168, 168, 168, 168, 168, 168, 168, 169, 45, 45, 45, 45, 418, 419, 418, 419, 418, 419, 418, 419, 418, 419, 418, 419, 418, 419, 
            168, 168, 168, 168, 168, 168, 168, 168, 168, 168, 168, 168, 168, 235, 45, 45, 45, 45, 482, 483, 482, 483, 482, 483, 482, 483, 482, 483, 482, 483, 482, 483, 
            168, 168, 168, 168, 168, 168, 168, 168, 168, 168, 168, 168, 168, 169, 45, 45, 45, 45, 418, 419, 418, 419, 418, 419, 418, 419, 418, 419, 418, 419, 418, 419, 
            168, 168, 168, 168, 168, 168, 168, 168, 168, 168, 168, 168, 168, 235, 45, 45, 45, 45, 482, 483, 482, 483, 482, 483, 482, 483, 482, 483, 482, 483, 482, 483, 
            168, 168, 168, 168, 168, 168, 168, 168, 168, 168, 168, 168, 168, 169, 45, 45, 45, 45, 45, 45, 45, 45, 45, 45, 45, 45, 45, 45, 45, 45, 45, 45, 
            168, 168, 168, 168, 168, 168, 168, 168, 168, 168, 168, 168, 168, 235, 45, 45, 45, 45, 45, 45, 45, 45, 45, 45, 45, 45, 45, 45, 45, 45, 45, 45, 
            168, 168, 168, 168, 168, 168, 168, 168, 168, 168, 168, 168, 168, 169, 45, 45, 45, 45, 45, 45, 45, 45, 45, 45, 45, 45, 45, 45, 45, 45, 45, 45, 
            168, 168, 168, 168, 168, 168, 168, 168, 168, 168, 168, 168, 168, 235, 45, 45, 45, 45, 45, 45, 45, 45, 45, 45, 45, 45, 45, 45, 45, 45, 45, 45, 
            168, 168, 168, 168, 168, 168, 168, 168, 168, 168, 168, 168, 168, 235, 45, 45, 45, 45, 45, 45, 418, 419, 45, 45, 418, 419, 418, 419, 45, 45, 45, 45, 
            164, 164, 164, 164, 164, 164, 164, 164, 164, 164, 164, 164, 164, 172, 45, 45, 45, 45, 45, 45, 482, 483, 45, 45, 482, 483, 482, 483, 45, 45, 45, 45, 
            045, 45, 45, 45, 45, 45, 45, 45, 45, 45, 45, 45, 45, 45, 45, 45, 45, 45, 45, 45, 45, 45, 45, 45, 45, 45, 45, 45, 45, 45, 45, 45, 
            045, 45, 45, 45, 45, 45, 45, 45, 45, 45, 45, 45, 45, 45, 45, 45, 45, 45, 45, 45, 45, 45, 45, 45, 45, 45, 45, 45, 45, 45, 45, 45, 
            423, 424, 423, 424, 423, 424, 45, 45, 45, 45, 45, 45, 45, 45, 45, 45, 45, 45, 45, 45, 418, 419, 45, 45, 418, 419, 418, 419, 45, 45, 45, 45, 
            487, 488, 487, 488, 487, 488, 45, 45, 45, 45, 45, 45, 45, 45, 45, 45, 45, 45, 45, 45, 482, 483, 45, 45, 482, 483, 482, 483, 45, 45, 45, 45, 
            428, 429, 428, 429, 428, 429, 45, 45, 45, 45, 45, 45, 45, 45, 45, 45, 45, 45, 45, 45, 45, 45, 45, 45, 45, 45, 45, 45, 45, 45, 45, 45, 
            492, 493, 492, 493, 492, 493, 45, 45, 45, 45, 45, 45, 45, 45, 45, 45, 45, 45, 45, 45, 45, 45, 45, 45, 45, 45, 45, 45, 45, 45, 45, 45, 
            428, 429, 428, 429, 428, 429, 45, 45, 45, 45, 45, 45, 45, 45, 45, 45, 45, 45, 45, 45, 45, 45, 45, 45, 45, 45, 45, 45, 45, 45, 45, 45, 
            492, 493, 492, 493, 492, 493, 45, 45, 45, 45, 45, 45, 45, 45, 45, 45, 45, 45, 45, 45, 45, 45, 45, 45, 45, 45, 45, 45, 45, 45, 45, 45, 
            428, 429, 428, 429, 428, 429, 418, 419, 418, 419, 418, 419, 418, 419, 418, 419, 418, 419, 418, 419, 418, 419, 418, 419, 418, 419, 418, 419, 418, 419, 418, 419, 
            492, 493, 492, 493, 492, 493, 482, 483, 482, 483, 482, 483, 482, 483, 482, 483, 482, 483, 482, 483, 482, 483, 482, 483, 482, 483, 482, 483, 482, 483, 482, 483, 
            428, 429, 428, 429, 428, 429, 418, 419, 418, 419, 418, 419, 418, 419, 418, 419, 418, 419, 418, 419, 418, 419, 418, 419, 418, 419, 418, 419, 418, 419, 418, 419, 
            492, 493, 492, 493, 492, 493, 482, 483, 482, 483, 482, 483, 482, 483, 482, 483, 482, 483, 482, 483, 482, 483, 482, 483, 482, 483, 482, 483, 482, 483, 482, 483, 
        ]
    }
}