{
    "tilemap": {
        "W": 32,
        "H": 22,
        "tilemap": [
            444, 445, 444, 445, 444, 445, 444, 445, 444, 445, 58, 122, 444, 445, 444, 445, 444, 445, 444, 445, 444, 445, 444, 445, 444, 445, 444, 445, 444, 445, 444, 445, 
            508, 509, 508, 509, 508, 509, 508, 509, 508, 509, 58, 122, 508, 509, 508, 509, 508, 509, 508, 509, 508, 509, 508, 509, 508, 509, 508, 509, 508, 509, 508, 509, 
            444, 445, 444, 445, 444, 445, 444, 445, 444, 445, 58, 122, 444, 445, 444, 445, 444, 445, 444, 445, 444, 445, 444, 445, 444, 445, 444, 445, 444, 445, 444, 445, 
            508, 509, 508, 509, 508, 509, 508, 509, 508, 509, 58, 122, 508, 509, 508, 509, 508, 509, 508, 509, 508, 509, 508, 509, 508, 509, 508, 509, 508, 509, 508, 509, 
            444, 445, 446, 447, 45, 45, 45, 45, 45, 45, 45, 45, 45, 45, 45, 45, 45, 45, 45, 45, 45, 45, 45, 45, 45, 45, 45, 45, 45, 45, 45, 45, 
            508, 509, 510, 495, 45, 45, 45, 45, 45, 45, 45, 45, 45, 45, 45, 45, 45, 45, 45, 45, 45, 45, 45, 45, 45, 45, 45, 45, 45, 45, 45, 45, 
            444, 445, 45, 45, 45, 45, 45, 45, 45, 45, 45, 45, 45, 45, 45, 45, 45, 45, 45, 45, 45, 45, 45, 45, 45, 45, 45, 45, 45, 45, 45, 45, 
            508, 509, 45, 45, 45, 45, 45, 45, 45, 45, 45, 45, 45, 45, 45, 45, 45, 45, 45, 45, 45, 45, 45, 45, 45, 45, 45, 45, 45, 45, 45, 45, 
            446, 447, 45, 45, 45, 45, 45, 45, 45, 45, 45, 45, 45, 45, 432, 433, 45, 45, 432, 433, 45, 45, 432, 433, 45, 45, 432, 433, 45, 45, 45, 45, 
            510, 495, 45, 45, 45, 45, 45, 45, 45, 45, 45, 45, 45, 45, 496, 497, 45, 45, 496, 497, 45, 45, 496, 497, 45, 45, 496, 497, 45, 45, 45, 45, 
            045, 45, 45, 45, 45, 45, 45, 45, 45, 45, 45, 45, 45, 45, 45, 45, 45, 45, 45, 45, 45, 45, 45, 45, 45, 45, 45, 45, 45, 45, 45, 45, 
            045, 45, 45, 45, 45, 45, 45, 45, 45, 45, 45, 45, 45, 45, 45, 45, 45, 45, 45, 45, 45, 45, 45, 45, 45, 45, 45, 45, 45, 45, 45, 45, 
            440, 441, 45, 45, 45, 45, 45, 45, 45, 45, 45, 45, 45, 45, 432, 433, 45, 45, 432, 433, 45, 45, 432, 433, 45, 45, 432, 433, 45, 45, 45, 45, 
            504, 505, 45, 45, 45, 45, 45, 45, 45, 45, 45, 45, 45, 45, 496, 497, 45, 45, 496, 497, 45, 45, 496, 497, 45, 45, 496, 497, 45, 45, 45, 45, 
            444, 445, 45, 45, 45, 45, 45, 45, 45, 45, 45, 45, 45, 45, 45, 45, 45, 45, 45, 45, 45, 45, 45, 45, 45, 45, 45, 45, 45, 45, 45, 45, 
            508, 509, 45, 45, 45, 45, 45, 45, 45, 45, 45, 45, 45, 45, 45, 45, 45, 45, 45, 45, 45, 45, 45, 45, 45, 45, 45, 45, 45, 45, 45, 45, 
            444, 445, 440, 441, 45, 45, 45, 45, 45, 45, 45, 45, 45, 45, 45, 45, 45, 45, 45, 45, 45, 45, 45, 45, 45, 45, 45, 45, 45, 45, 45, 45, 
            508, 509, 504, 505, 45, 45, 45, 45, 45, 45, 45, 45, 45, 45, 45, 45, 45, 45, 45, 45, 45, 45, 45, 45, 45, 45, 45, 45, 45, 45, 45, 45, 
            444, 445, 444, 445, 439, 440, 58, 122, 439, 440, 439, 440, 439, 440, 439, 440, 439, 440, 439, 440, 439, 440, 439, 440, 439, 440, 439, 440, 439, 440, 439, 440, 
            508, 509, 508, 509, 503, 504, 58, 122, 503, 504, 503, 504, 503, 504, 503, 504, 503, 504, 503, 504, 503, 504, 503, 504, 503, 504, 503, 504, 503, 504, 503, 504, 
            444, 445, 444, 445, 444, 445, 58, 122, 444, 445, 444, 445, 444, 445, 444, 445, 444, 445, 444, 445, 444, 445, 444, 445, 444, 445, 444, 445, 444, 445, 444, 445, 
            508, 509, 508, 509, 508, 509, 58, 122, 508, 509, 508, 509, 508, 509, 508, 509, 508, 509, 508, 509, 508, 509, 508, 509, 508, 509, 508, 509, 508, 509, 508, 509, 
        ]
    }
}