{
    "tilemap": {
        "W": 32,
        "H": 22,
        "tilemap": [
            184, 184, 184, 184, 184, 184, 184, 184, 184, 184, 184, 184, 184, 185, 45, 45, 45, 45, 434, 435, 434, 435, 434, 435, 434, 435, 434, 435, 434, 435, 434, 435, 
            184, 184, 184, 184, 184, 184, 184, 184, 184, 184, 184, 184, 184, 251, 45, 45, 45, 45, 498, 499, 498, 499, 498, 499, 498, 499, 498, 499, 498, 499, 498, 499, 
            184, 184, 184, 184, 184, 184, 184, 184, 184, 184, 184, 184, 184, 185, 45, 45, 45, 45, 434, 435, 434, 435, 434, 435, 434, 435, 434, 435, 434, 435, 434, 435, 
            184, 184, 184, 184, 184, 184, 184, 184, 184, 184, 184, 184, 184, 251, 45, 45, 45, 45, 498, 499, 498, 499, 498, 499, 498, 499, 498, 499, 498, 499, 498, 499, 
            184, 184, 184, 184, 184, 184, 184, 184, 184, 184, 184, 184, 184, 185, 45, 45, 45, 45, 45, 45, 434, 435, 45, 45, 45, 45, 45, 45, 45, 45, 434, 435, 
            184, 184, 184, 184, 184, 184, 184, 184, 184, 184, 184, 184, 184, 251, 45, 45, 45, 45, 45, 45, 498, 499, 45, 45, 45, 45, 45, 45, 45, 45, 498, 499, 
            184, 184, 184, 184, 184, 184, 184, 184, 184, 184, 184, 184, 184, 185, 45, 45, 45, 45, 45, 45, 45, 45, 45, 45, 45, 45, 45, 45, 45, 45, 434, 435, 
            184, 184, 184, 184, 184, 184, 184, 184, 184, 184, 184, 184, 184, 251, 45, 45, 45, 45, 45, 45, 45, 45, 45, 45, 45, 45, 45, 45, 45, 45, 498, 499, 
            184, 184, 184, 184, 184, 184, 184, 184, 184, 184, 184, 184, 184, 185, 45, 45, 45, 45, 45, 45, 45, 45, 45, 45, 434, 435, 45, 45, 45, 45, 434, 435, 
            184, 184, 184, 184, 184, 184, 184, 184, 184, 184, 184, 184, 184, 251, 45, 45, 45, 45, 45, 45, 45, 45, 45, 45, 498, 499, 45, 45, 45, 45, 498, 499, 
            059, 59, 59, 59, 59, 59, 59, 59, 59, 59, 59, 59, 59, 59, 45, 45, 45, 45, 45, 45, 45, 45, 45, 45, 45, 45, 45, 45, 45, 45, 434, 435, 
            123, 123, 123, 123, 123, 123, 123, 123, 123, 123, 123, 123, 123, 123, 45, 45, 45, 45, 45, 45, 45, 45, 45, 45, 45, 45, 45, 45, 45, 45, 498, 499, 
            184, 184, 184, 184, 184, 184, 184, 184, 184, 184, 184, 184, 184, 185, 45, 45, 45, 45, 45, 45, 45, 45, 45, 45, 434, 435, 45, 45, 45, 45, 434, 435, 
            184, 184, 184, 184, 184, 184, 184, 184, 184, 184, 184, 184, 184, 251, 45, 45, 45, 45, 45, 45, 45, 45, 45, 45, 498, 499, 45, 45, 45, 45, 498, 499, 
            184, 184, 184, 184, 184, 184, 184, 184, 184, 184, 184, 184, 184, 185, 45, 45, 45, 45, 45, 45, 45, 45, 45, 45, 45, 45, 45, 45, 45, 45, 434, 435, 
            184, 184, 184, 184, 184, 184, 184, 184, 184, 184, 184, 184, 184, 251, 45, 45, 45, 45, 45, 45, 45, 45, 45, 45, 45, 45, 45, 45, 45, 45, 498, 499, 
            184, 184, 184, 184, 184, 184, 184, 184, 184, 184, 184, 184, 184, 185, 45, 45, 45, 45, 45, 45, 434, 435, 45, 45, 45, 45, 45, 45, 45, 45, 434, 435, 
            184, 184, 184, 184, 184, 184, 184, 184, 184, 184, 184, 184, 184, 251, 45, 45, 45, 45, 45, 45, 498, 499, 45, 45, 45, 45, 45, 45, 45, 45, 498, 499, 
            184, 184, 184, 184, 184, 184, 184, 184, 184, 184, 184, 184, 184, 185, 45, 45, 45, 45, 434, 435, 434, 435, 434, 435, 434, 435, 434, 435, 434, 435, 434, 435, 
            184, 184, 184, 184, 184, 184, 184, 184, 184, 184, 184, 184, 184, 251, 45, 45, 45, 45, 498, 499, 498, 499, 498, 499, 498, 499, 498, 499, 498, 499, 498, 499, 
            184, 184, 184, 184, 184, 184, 184, 184, 184, 184, 184, 184, 184, 185, 45, 45, 45, 45, 434, 435, 434, 435, 434, 435, 434, 435, 434, 435, 434, 435, 434, 435, 
            184, 184, 184, 184, 184, 184, 184, 184, 184, 184, 184, 184, 184, 251, 45, 45, 45, 45, 498, 499, 498, 499, 498, 499, 498, 499, 498, 499, 498, 499, 498, 499, 
        ]
    }
}