{
    "tilemap": {
        "W": 32,
        "H": 22,
        "tilemap": [
            444, 445, 444, 445, 444, 445, 444, 445, 444, 445, 444, 445, 444, 445, 444, 445, 444, 445, 444, 445, 444, 445, 444, 445, 444, 445, 444, 445, 444, 445, 444, 445, 
            508, 509, 508, 509, 508, 509, 508, 509, 508, 509, 508, 509, 508, 509, 508, 509, 508, 509, 508, 509, 508, 509, 508, 509, 508, 509, 508, 509, 508, 509, 508, 509, 
            444, 445, 444, 445, 444, 445, 444, 445, 444, 445, 444, 445, 444, 445, 444, 445, 444, 445, 444, 445, 444, 445, 444, 445, 444, 445, 444, 445, 444, 445, 444, 445, 
            508, 509, 508, 509, 508, 509, 508, 509, 508, 509, 508, 509, 508, 509, 508, 509, 508, 509, 508, 509, 508, 509, 508, 509, 508, 509, 508, 509, 508, 509, 508, 509, 
            444, 445, 444, 445, 13, 13, 13, 13, 13, 13, 13, 13, 13, 13, 13, 13, 13, 13, 13, 13, 13, 13, 13, 13, 13, 13, 13, 13, 444, 445, 444, 445, 
            508, 509, 508, 509, 13, 13, 13, 13, 13, 13, 13, 13, 13, 13, 13, 13, 13, 13, 13, 13, 13, 13, 13, 13, 13, 13, 13, 13, 508, 509, 508, 509, 
            444, 445, 444, 445, 13, 13, 13, 13, 13, 13, 13, 13, 13, 143, 512, 513, 512, 513, 141, 13, 13, 13, 13, 13, 13, 13, 13, 13, 444, 445, 444, 445, 
            508, 509, 508, 509, 13, 13, 13, 13, 13, 13, 13, 13, 206, 207, 576, 577, 576, 577, 205, 206, 13, 13, 13, 13, 13, 13, 13, 13, 508, 509, 508, 509, 
            444, 445, 444, 445, 13, 13, 384, 385, 384, 385, 384, 385, 257, 258, 00, 00, 00, 00, 256, 257, 384, 385, 384, 385, 384, 385, 13, 13, 444, 445, 444, 445, 
            508, 509, 508, 509, 13, 13, 448, 449, 448, 449, 448, 449, 321, 322, 00, 00, 00, 00, 320, 321, 448, 449, 448, 449, 448, 449, 13, 13, 508, 509, 508, 509, 
            444, 445, 444, 445, 13, 13, 13, 13, 13, 13, 13, 13, 13, 13, 13, 13, 13, 13, 13, 13, 13, 13, 13, 13, 13, 13, 13, 13, 444, 445, 444, 445, 
            508, 509, 508, 509, 13, 13, 13, 13, 13, 13, 13, 13, 13, 13, 13, 13, 13, 13, 13, 13, 13, 13, 13, 13, 13, 13, 13, 13, 508, 509, 508, 509, 
            444, 445, 444, 445, 13, 13, 384, 385, 384, 385, 384, 385, 13, 13, 13, 13, 13, 13, 13, 13, 384, 385, 384, 385, 384, 385, 13, 13, 444, 445, 444, 445, 
            508, 509, 508, 509, 13, 13, 448, 449, 448, 449, 448, 449, 13, 13, 13, 13, 13, 13, 13, 13, 448, 449, 448, 449, 448, 449, 13, 13, 508, 509, 508, 509, 
            444, 445, 444, 445, 13, 13, 13, 13, 13, 13, 13, 13, 13, 13, 13, 13, 13, 13, 13, 13, 13, 13, 13, 13, 13, 13, 13, 13, 444, 445, 444, 445, 
            508, 509, 508, 509, 13, 13, 13, 13, 13, 13, 13, 13, 13, 13, 13, 13, 13, 13, 13, 13, 13, 13, 13, 13, 13, 13, 13, 13, 508, 509, 508, 509, 
            444, 445, 444, 445, 13, 13, 13, 13, 13, 13, 13, 13, 13, 13, 13, 13, 13, 13, 13, 13, 13, 13, 13, 13, 13, 13, 13, 13, 444, 445, 444, 445, 
            508, 509, 508, 509, 13, 13, 13, 13, 13, 13, 13, 13, 13, 13, 13, 13, 13, 13, 13, 13, 13, 13, 13, 13, 13, 13, 13, 13, 508, 509, 508, 509, 
            444, 445, 444, 445, 439, 440, 439, 440, 439, 440, 439, 440, 439, 440, 58, 122, 439, 440, 439, 440, 439, 440, 439, 440, 439, 440, 439, 440, 444, 445, 444, 445, 
            508, 509, 508, 509, 503, 504, 503, 504, 503, 504, 503, 504, 503, 504, 58, 122, 503, 504, 503, 504, 503, 504, 503, 504, 503, 504, 503, 504, 508, 509, 508, 509, 
            444, 445, 444, 445, 444, 445, 444, 445, 444, 445, 444, 445, 444, 445, 58, 122, 444, 445, 444, 445, 444, 445, 444, 445, 444, 445, 444, 445, 444, 445, 444, 445, 
            508, 509, 508, 509, 508, 509, 508, 509, 508, 509, 508, 509, 508, 509, 58, 122, 508, 509, 508, 509, 508, 509, 508, 509, 508, 509, 508, 509, 508, 509, 508, 509, 
        ]
    }
}