{
    "tilemap": {
        "W": 32,
        "H": 22,
        "tilemap": [
            396, 397, 396, 397, 13, 13, 13, 13, 13, 13, 13, 13, 13, 13, 13, 13, 13, 13, 13, 13, 13, 13, 13, 13, 13, 13, 13, 13, 386, 387, 386, 387, 
            460, 461, 460, 461, 13, 13, 13, 13, 13, 13, 13, 13, 13, 13, 13, 13, 13, 13, 13, 13, 13, 13, 13, 13, 13, 13, 13, 13, 450, 451, 450, 451, 
            396, 397, 396, 397, 13, 13, 13, 13, 13, 13, 13, 13, 13, 13, 13, 13, 13, 13, 13, 13, 13, 13, 13, 13, 13, 13, 13, 13, 386, 387, 386, 387, 
            460, 461, 460, 461, 13, 13, 13, 13, 13, 13, 13, 13, 13, 13, 13, 13, 13, 13, 13, 13, 13, 13, 13, 13, 13, 13, 13, 13, 450, 451, 450, 451, 
            013, 13, 13, 13, 13, 13, 13, 13, 13, 13, 13, 13, 13, 13, 13, 13, 13, 13, 13, 13, 13, 13, 13, 13, 13, 13, 13, 13, 386, 387, 386, 387, 
            013, 13, 13, 13, 13, 13, 13, 13, 13, 13, 13, 13, 13, 13, 13, 13, 13, 13, 13, 13, 13, 13, 13, 13, 13, 13, 13, 13, 450, 451, 450, 451, 
            013, 13, 13, 13, 13, 13, 270, 271, 13, 13, 13, 13, 270, 271, 13, 13, 13, 13, 270, 271, 13, 13, 13, 13, 270, 271, 13, 13, 386, 387, 386, 387, 
            013, 13, 13, 13, 13, 13, 334, 335, 13, 13, 13, 13, 334, 335, 13, 13, 13, 13, 334, 335, 13, 13, 13, 13, 334, 335, 13, 13, 450, 451, 450, 451, 
            013, 13, 13, 13, 13, 13, 13, 13, 13, 13, 13, 13, 13, 13, 13, 13, 13, 13, 13, 13, 13, 13, 13, 13, 13, 13, 13, 13, 386, 387, 386, 387, 
            013, 13, 13, 13, 13, 13, 13, 13, 13, 13, 13, 13, 13, 13, 13, 13, 13, 13, 13, 13, 13, 13, 13, 13, 13, 13, 13, 13, 450, 451, 450, 451, 
            013, 13, 13, 13, 13, 13, 270, 271, 13, 13, 13, 13, 270, 271, 13, 13, 13, 13, 270, 271, 13, 13, 13, 13, 270, 271, 13, 13, 386, 387, 386, 387, 
            013, 13, 13, 13, 13, 13, 334, 335, 13, 13, 13, 13, 334, 335, 13, 13, 13, 13, 334, 335, 13, 13, 13, 13, 334, 335, 13, 13, 450, 451, 450, 451, 
            013, 13, 13, 13, 13, 13, 13, 13, 13, 13, 13, 13, 13, 13, 13, 13, 13, 13, 13, 13, 13, 13, 13, 13, 13, 13, 13, 13, 386, 387, 386, 387, 
            013, 13, 13, 13, 13, 13, 13, 13, 13, 13, 13, 13, 13, 13, 13, 13, 13, 13, 13, 13, 13, 13, 13, 13, 13, 13, 13, 13, 450, 451, 450, 451, 
            013, 13, 13, 13, 13, 13, 270, 271, 13, 13, 13, 13, 270, 271, 13, 13, 13, 13, 270, 271, 13, 13, 13, 13, 270, 271, 13, 13, 386, 387, 386, 387, 
            013, 13, 13, 13, 13, 13, 334, 335, 13, 13, 13, 13, 334, 335, 13, 13, 13, 13, 334, 335, 13, 13, 13, 13, 334, 335, 13, 13, 450, 451, 450, 451, 
            013, 13, 13, 13, 13, 13, 13, 13, 13, 13, 13, 13, 13, 13, 13, 13, 13, 13, 13, 13, 13, 13, 13, 13, 13, 13, 13, 13, 386, 387, 386, 387, 
            013, 13, 13, 13, 13, 13, 13, 13, 13, 13, 13, 13, 13, 13, 13, 13, 13, 13, 13, 13, 13, 13, 13, 13, 13, 13, 13, 13, 450, 451, 450, 451, 
            391, 392, 391, 392, 391, 392, 391, 392, 391, 392, 391, 392, 391, 392, 391, 392, 391, 392, 391, 392, 391, 392, 391, 392, 391, 392, 391, 392, 386, 387, 386, 387, 
            455, 456, 455, 456, 455, 456, 455, 456, 455, 456, 455, 456, 455, 456, 455, 456, 455, 456, 455, 456, 455, 456, 455, 456, 455, 456, 455, 456, 450, 451, 450, 451, 
            396, 397, 396, 397, 396, 397, 396, 397, 396, 397, 396, 397, 396, 397, 396, 397, 396, 397, 396, 397, 396, 397, 396, 397, 396, 397, 396, 397, 386, 387, 386, 387, 
            460, 461, 460, 461, 460, 461, 460, 461, 460, 461, 460, 461, 460, 461, 460, 461, 460, 461, 460, 461, 460, 461, 460, 461, 460, 461, 460, 461, 450, 451, 450, 451, 
        ]
    }
}