{
    "tilemap": {
        "W": 32,
        "H": 22,
        "tilemap": [
            396, 397, 396, 397, 396, 397, 396, 397, 396, 397, 396, 397, 396, 397, 396, 397, 396, 397, 396, 397, 396, 397, 396, 397, 396, 397, 396, 397, 396, 397, 396, 397, 
            460, 461, 460, 461, 460, 461, 460, 461, 460, 461, 460, 461, 460, 461, 460, 461, 460, 461, 460, 461, 460, 461, 460, 461, 460, 461, 460, 461, 460, 461, 460, 461, 
            396, 397, 396, 397, 396, 397, 396, 397, 396, 397, 396, 397, 396, 397, 396, 397, 396, 397, 396, 397, 396, 397, 396, 397, 396, 397, 396, 397, 396, 397, 396, 397, 
            460, 461, 460, 461, 460, 461, 460, 461, 460, 461, 460, 461, 460, 461, 460, 461, 460, 461, 460, 461, 460, 461, 460, 461, 460, 461, 460, 461, 460, 461, 460, 461, 
            396, 397, 396, 397, 398, 399, 13, 13, 13, 13, 13, 13, 13, 13, 13, 13, 13, 13, 13, 13, 13, 13, 13, 13, 13, 13, 13, 13, 13, 13, 13, 13, 
            460, 461, 460, 461, 462, 463, 13, 13, 13, 13, 13, 13, 13, 13, 13, 13, 13, 13, 13, 13, 13, 13, 13, 13, 13, 13, 13, 13, 13, 13, 13, 13, 
            396, 397, 396, 397, 13, 13, 270, 271, 13, 13, 13, 13, 270, 271, 13, 13, 13, 13, 270, 271, 13, 13, 13, 13, 270, 271, 13, 13, 13, 13, 13, 13, 
            460, 461, 460, 461, 13, 13, 334, 335, 13, 13, 13, 13, 334, 335, 13, 13, 13, 13, 334, 335, 13, 13, 13, 13, 334, 335, 13, 13, 13, 13, 13, 13, 
            396, 397, 396, 397, 13, 13, 13, 13, 13, 13, 13, 13, 13, 13, 13, 13, 13, 13, 13, 13, 13, 13, 13, 13, 13, 13, 13, 13, 13, 13, 13, 13, 
            460, 461, 460, 461, 13, 13, 13, 13, 13, 13, 13, 13, 13, 13, 13, 13, 13, 13, 13, 13, 13, 13, 13, 13, 13, 13, 13, 13, 13, 13, 13, 13, 
            396, 397, 396, 397, 13, 13, 270, 271, 13, 13, 13, 13, 270, 271, 13, 13, 13, 13, 270, 271, 13, 13, 13, 13, 270, 271, 13, 13, 13, 13, 13, 13, 
            460, 461, 460, 461, 13, 13, 334, 335, 13, 13, 13, 13, 334, 335, 13, 13, 13, 13, 334, 335, 13, 13, 13, 13, 334, 335, 13, 13, 13, 13, 13, 13, 
            396, 397, 396, 397, 13, 13, 13, 13, 13, 13, 13, 13, 13, 13, 13, 13, 13, 13, 13, 13, 13, 13, 13, 13, 13, 13, 13, 13, 13, 13, 13, 13, 
            460, 461, 460, 461, 13, 13, 13, 13, 13, 13, 13, 13, 13, 13, 13, 13, 13, 13, 13, 13, 13, 13, 13, 13, 13, 13, 13, 13, 13, 13, 13, 13, 
            396, 397, 396, 397, 13, 13, 270, 271, 13, 13, 13, 13, 270, 271, 13, 13, 13, 13, 270, 271, 13, 13, 13, 13, 270, 271, 13, 13, 13, 13, 13, 13, 
            460, 461, 460, 461, 13, 13, 334, 335, 13, 13, 13, 13, 334, 335, 13, 13, 13, 13, 334, 335, 13, 13, 13, 13, 334, 335, 13, 13, 13, 13, 13, 13, 
            396, 397, 396, 397, 13, 13, 13, 13, 13, 13, 13, 13, 13, 13, 13, 13, 13, 13, 13, 13, 13, 13, 13, 13, 13, 13, 13, 13, 13, 13, 13, 13, 
            460, 461, 460, 461, 13, 13, 13, 13, 13, 13, 13, 13, 13, 13, 13, 13, 13, 13, 13, 13, 13, 13, 13, 13, 13, 13, 13, 13, 13, 13, 13, 13, 
            396, 397, 396, 397, 13, 13, 13, 13, 13, 13, 13, 13, 13, 13, 13, 13, 13, 13, 13, 13, 13, 13, 13, 13, 13, 13, 13, 13, 391, 392, 391, 392, 
            460, 461, 460, 461, 13, 13, 13, 13, 13, 13, 13, 13, 13, 13, 13, 13, 13, 13, 13, 13, 13, 13, 13, 13, 13, 13, 13, 13, 455, 456, 455, 456, 
            396, 397, 396, 397, 13, 13, 13, 13, 13, 13, 13, 13, 13, 13, 13, 13, 13, 13, 13, 13, 13, 13, 13, 13, 13, 13, 13, 13, 396, 397, 396, 397, 
            460, 461, 460, 461, 13, 13, 13, 13, 13, 13, 13, 13, 13, 13, 13, 13, 13, 13, 13, 13, 13, 13, 13, 13, 13, 13, 13, 13, 460, 461, 460, 461, 
        ]
    }
}