{
    "tilemap": {
        "W": 32,
        "H": 22,
        "tilemap": [
            428, 429, 428, 429, 45, 45, 45, 45, 45, 45, 168, 168, 168, 168, 45, 45, 45, 45, 45, 45, 428, 429, 45, 45, 428, 429, 45, 45, 428, 429, 428, 429, 
            492, 493, 492, 493, 45, 45, 45, 45, 45, 45, 168, 168, 168, 168, 45, 45, 45, 45, 45, 45, 492, 493, 45, 45, 492, 493, 45, 45, 492, 493, 492, 493, 
            428, 429, 430, 431, 45, 45, 45, 45, 45, 45, 168, 168, 168, 168, 45, 45, 45, 45, 45, 45, 428, 429, 45, 45, 428, 429, 45, 45, 426, 427, 428, 429, 
            492, 493, 494, 495, 45, 45, 45, 45, 45, 45, 168, 168, 168, 168, 45, 45, 45, 45, 45, 45, 492, 493, 45, 45, 492, 493, 45, 45, 490, 491, 492, 493, 
            045, 45, 45, 45, 45, 45, 45, 45, 45, 45, 184, 184, 184, 184, 45, 45, 45, 45, 45, 45, 45, 45, 45, 45, 45, 45, 45, 45, 45, 45, 45, 45, 
            045, 45, 45, 45, 45, 45, 45, 45, 45, 45, 184, 184, 184, 184, 45, 45, 45, 45, 45, 45, 45, 45, 45, 45, 45, 45, 45, 45, 45, 45, 45, 45, 
            045, 45, 45, 45, 45, 45, 45, 45, 45, 45, 184, 184, 184, 184, 45, 45, 45, 45, 45, 45, 436, 437, 45, 45, 45, 45, 45, 45, 45, 45, 45, 45, 
            045, 45, 45, 45, 45, 45, 45, 45, 45, 45, 184, 184, 184, 184, 45, 45, 45, 45, 45, 45, 500, 501, 45, 45, 45, 45, 45, 45, 45, 45, 45, 45, 
            045, 45, 45, 45, 45, 45, 45, 45, 45, 45, 184, 184, 184, 184, 45, 45, 45, 45, 45, 45, 45, 45, 45, 45, 436, 437, 45, 45, 45, 45, 45, 45, 
            045, 45, 45, 45, 45, 45, 45, 45, 45, 45, 184, 184, 184, 184, 45, 45, 45, 45, 45, 45, 45, 45, 45, 45, 500, 501, 45, 45, 45, 45, 45, 45, 
            045, 45, 45, 45, 45, 45, 45, 45, 45, 45, 59, 59, 59, 59, 45, 45, 45, 45, 45, 45, 436, 437, 45, 45, 45, 45, 45, 45, 45, 45, 45, 45, 
            045, 45, 45, 45, 45, 45, 45, 45, 45, 45, 123, 123, 123, 123, 45, 45, 45, 45, 45, 45, 500, 501, 45, 45, 45, 45, 45, 45, 45, 45, 45, 45, 
            045, 45, 45, 45, 45, 45, 45, 45, 45, 45, 184, 184, 184, 184, 45, 45, 45, 45, 45, 45, 45, 45, 45, 45, 436, 437, 45, 45, 45, 45, 45, 45, 
            045, 45, 45, 45, 45, 45, 45, 45, 45, 45, 184, 184, 184, 184, 45, 45, 45, 45, 45, 45, 45, 45, 45, 45, 500, 501, 45, 45, 45, 45, 45, 45, 
            045, 45, 45, 45, 45, 45, 45, 45, 45, 45, 184, 184, 184, 184, 45, 45, 45, 45, 45, 45, 436, 437, 45, 45, 45, 45, 45, 45, 45, 45, 45, 45, 
            045, 45, 45, 45, 45, 45, 45, 45, 45, 45, 184, 184, 184, 184, 45, 45, 45, 45, 45, 45, 500, 501, 45, 45, 45, 45, 45, 45, 45, 45, 45, 45, 
            045, 45, 45, 45, 45, 45, 45, 45, 45, 45, 184, 184, 184, 184, 45, 45, 45, 45, 45, 45, 45, 45, 45, 45, 45, 45, 45, 45, 45, 45, 45, 45, 
            045, 45, 45, 45, 45, 45, 45, 45, 45, 45, 184, 184, 184, 184, 45, 45, 45, 45, 45, 45, 45, 45, 45, 45, 45, 45, 45, 45, 45, 45, 45, 45, 
            423, 424, 423, 424, 423, 424, 424, 425, 45, 45, 168, 168, 168, 168, 423, 424, 423, 424, 423, 424, 423, 424, 423, 424, 423, 424, 423, 424, 423, 424, 423, 424, 
            487, 488, 487, 488, 487, 488, 488, 489, 45, 45, 168, 168, 168, 168, 487, 488, 487, 488, 487, 488, 487, 488, 487, 488, 487, 488, 487, 488, 487, 488, 487, 488, 
            428, 429, 428, 429, 428, 429, 428, 429, 45, 45, 168, 168, 168, 168, 428, 429, 428, 429, 428, 429, 428, 429, 428, 429, 428, 429, 428, 429, 428, 429, 428, 429, 
            492, 493, 492, 493, 492, 493, 492, 493, 45, 45, 168, 168, 168, 168, 492, 493, 492, 493, 492, 493, 492, 493, 492, 493, 492, 493, 492, 493, 492, 493, 492, 493, 
        ]
    }
}