{
    "tilemap": {
        "W": 32,
        "H": 22,
        "tilemap": [
            444, 445, 444, 445, 444, 445, 444, 445, 444, 445, 444, 445, 444, 445, 444, 445, 444, 445, 444, 445, 444, 445, 444, 445, 444, 445, 444, 445, 444, 445, 444, 445, 
            508, 509, 508, 509, 508, 509, 508, 509, 508, 509, 508, 509, 508, 509, 508, 509, 508, 509, 508, 509, 508, 509, 508, 509, 508, 509, 508, 509, 508, 509, 508, 509, 
            444, 445, 444, 445, 444, 445, 444, 445, 444, 445, 444, 445, 444, 445, 444, 445, 444, 445, 444, 445, 444, 445, 444, 445, 444, 445, 444, 445, 444, 445, 444, 445, 
            508, 509, 508, 509, 508, 509, 508, 509, 508, 509, 508, 509, 508, 509, 508, 509, 508, 509, 508, 509, 508, 509, 508, 509, 508, 509, 508, 509, 508, 509, 508, 509, 
            444, 445, 446, 447, 45, 45, 45, 45, 45, 45, 442, 443, 444, 445, 444, 445, 446, 447, 45, 45, 444, 445, 444, 445, 444, 445, 444, 445, 444, 445, 444, 445, 
            508, 509, 510, 495, 45, 45, 45, 45, 45, 45, 506, 507, 508, 509, 508, 509, 510, 495, 45, 45, 508, 509, 508, 509, 508, 509, 508, 509, 508, 509, 508, 509, 
            444, 445, 45, 45, 45, 45, 45, 45, 45, 45, 45, 45, 442, 443, 446, 447, 45, 45, 45, 45, 442, 443, 444, 445, 446, 447, 442, 443, 444, 445, 446, 447, 
            508, 509, 45, 45, 45, 45, 45, 45, 45, 45, 45, 45, 506, 507, 510, 495, 45, 45, 45, 45, 506, 507, 508, 509, 510, 495, 506, 507, 508, 509, 510, 495, 
            444, 445, 45, 45, 45, 45, 45, 45, 45, 45, 45, 45, 45, 45, 45, 45, 45, 45, 45, 45, 45, 45, 45, 45, 45, 45, 45, 45, 45, 45, 45, 45, 
            508, 509, 45, 45, 45, 45, 45, 45, 45, 45, 45, 45, 45, 45, 45, 45, 45, 45, 45, 45, 45, 45, 45, 45, 45, 45, 45, 45, 45, 45, 45, 45, 
            444, 445, 45, 45, 45, 45, 45, 45, 45, 45, 45, 45, 45, 45, 45, 45, 45, 45, 45, 45, 45, 45, 45, 45, 45, 45, 45, 45, 45, 45, 45, 45, 
            508, 509, 45, 45, 45, 45, 45, 45, 45, 45, 45, 45, 45, 45, 45, 45, 45, 45, 45, 45, 45, 45, 45, 45, 45, 45, 45, 45, 45, 45, 45, 45, 
            444, 445, 45, 45, 45, 45, 45, 45, 45, 45, 45, 45, 45, 45, 45, 45, 45, 45, 246, 247, 247, 247, 247, 247, 247, 247, 247, 247, 247, 247, 247, 247, 
            508, 509, 45, 45, 45, 45, 45, 45, 45, 45, 45, 45, 45, 45, 45, 45, 45, 45, 183, 184, 184, 184, 184, 184, 184, 184, 184, 184, 184, 184, 184, 184, 
            444, 445, 45, 45, 45, 45, 45, 45, 45, 45, 45, 45, 438, 439, 440, 441, 45, 45, 183, 184, 184, 184, 184, 184, 184, 184, 184, 184, 184, 184, 184, 184, 
            508, 509, 45, 45, 45, 45, 45, 45, 45, 45, 45, 45, 502, 503, 504, 505, 45, 45, 249, 184, 184, 184, 184, 184, 184, 184, 184, 184, 184, 184, 184, 184, 
            444, 445, 440, 441, 45, 45, 45, 45, 45, 45, 438, 439, 444, 445, 444, 445, 440, 441, 183, 184, 184, 184, 184, 184, 184, 184, 184, 184, 184, 184, 184, 184, 
            508, 509, 504, 505, 45, 45, 45, 45, 45, 45, 502, 503, 508, 509, 508, 509, 504, 505, 249, 184, 184, 184, 184, 184, 184, 184, 184, 184, 184, 184, 184, 184, 
            444, 445, 444, 445, 45, 45, 45, 45, 439, 440, 444, 445, 444, 445, 444, 445, 444, 445, 183, 184, 184, 184, 184, 184, 184, 184, 184, 184, 184, 184, 184, 184, 
            508, 509, 508, 509, 45, 45, 45, 45, 503, 504, 508, 509, 508, 509, 508, 509, 508, 509, 249, 184, 184, 184, 184, 184, 184, 184, 184, 184, 184, 184, 184, 184, 
            444, 445, 444, 445, 45, 45, 45, 45, 444, 445, 444, 445, 444, 445, 444, 445, 444, 445, 183, 184, 184, 184, 184, 184, 184, 184, 184, 184, 184, 184, 184, 184, 
            508, 509, 508, 509, 45, 45, 45, 45, 508, 509, 508, 509, 508, 509, 508, 509, 508, 509, 249, 184, 184, 184, 184, 184, 184, 184, 184, 184, 184, 184, 184, 184, 
        ]
    }
}